Año,Mes,Nacionalidad,Femenino,Masculino,Indefinido,Total
2012,Enero,Islas Alboran y Perejil,1,0,0,1
2012,Enero,Albania,1,2,0,3
2012,Enero,Alemania,1396,2439,0,3835
2012,Enero,Andorra,6,11,0,17
2012,Enero,Angola,1,1,0,2
2012,Enero,Antigua y Barbuda,1,1,0,2
2012,Enero,Países Bajos,798,1418,0,2216
2012,Enero,Argelia,3,4,0,7
2012,Enero,Argentina,5696,6082,0,11778
2012,Enero,Aruba,0,2,0,2
2012,Enero,Australia,379,678,0,1057
2012,Enero,Austria,151,328,0,479
2012,Enero,Azerbaiyán,1,2,0,3
2012,Enero,Bahamas,2,5,0,7
2012,Enero,Bahréin,0,1,0,1
2012,Enero,Bangladesh,0,1,0,1
2012,Enero,Barbados,3,3,0,6
2012,Enero,República de Belarús,5,5,0,10
2012,Enero,Bélgica,172,380,0,552
2012,Enero,Belice,9,11,0,20
2012,Enero,Bermudas/Territorio Británico de Ultramar,0,2,0,2
2012,Enero,Bolivia,404,512,0,916
2012,Enero,Bosnia y Herzegovina,0,1,0,1
2012,Enero,Botsuana,0,1,0,1
2012,Enero,Brasil,4231,5579,0,9810
2012,Enero,Bulgaria,8,13,0,21
2012,Enero,Burkina Faso,1,0,0,1
2012,Enero,Islas Caimán/Territorio Británico de Ultramar,2,8,0,10
2012,Enero,Camerún,1,2,0,3
2012,Enero,Canadá,2785,3644,0,6429
2012,Enero,Chad,0,2,0,2
2012,Enero,España,2381,5165,0,7546
2012,Enero,República Democrática del Congo,0,3,0,3
2012,Enero,República de Corea,145,344,0,489
2012,Enero,Costa de Marfil,1,1,0,2
2012,Enero,Costa Rica,960,1107,0,2067
2012,Enero,Croacia,11,18,0,29
2012,Enero,Cuba,172,282,0,454
2012,Enero,Curazao,1,1,0,2
2012,Enero,República Checa,54,82,0,136
2012,Enero,Chile,2251,3278,0,5529
2012,Enero,China,113,264,0,377
2012,Enero,Chipre,1,2,0,3
2012,Enero,Dinamarca,72,171,0,243
2012,Enero,Dominica,1,5,0,6
2012,Enero,Ecuador,3068,4894,0,7962
2012,Enero,Egipto,0,9,0,9
2012,Enero,El Salvador,373,554,0,927
2012,Enero,Eslovaquia,16,37,0,53
2012,Enero,Eslovenia,35,43,0,78
2012,Enero,Estados Unidos de América,6889,14798,0,21687
2012,Enero,Estonia,10,14,0,24
2012,Enero,Etiopia,0,2,0,2
2012,Enero,Filipinas,28,146,0,174
2012,Enero,Finlandia,270,289,0,559
2012,Enero,Francia,1319,2117,0,3436
2012,Enero,Gabón,0,1,0,1
2012,Enero,Georgia,1,0,0,1
2012,Enero,Ghana,0,5,0,5
2012,Enero,Granada,0,1,0,1
2012,Enero,Grecia,13,97,0,110
2012,Enero,Guatemala,209,405,0,614
2012,Enero,Guyana,3,2,0,5
2012,Enero,Guinea,1,0,0,1
2012,Enero,Guinea Ecuatorial,0,1,0,1
2012,Enero,Guayana Francesa/Departamento de Ultramar Francés,0,1,0,1
2012,Enero,Haití,7,24,0,31
2012,Enero,Honduras,127,219,0,346
2012,Enero,Hungría,43,59,0,102
2012,Enero,India,41,239,0,280
2012,Enero,Indonesia,17,16,0,33
2012,Enero,Irán,3,14,0,17
2012,Enero,República de Irlanda,63,162,0,225
2012,Enero,Islandia,9,6,0,15
2012,Enero,Isla de Man,88,206,0,294
2012,Enero,Isla Johnston,0,2,0,2
2012,Enero,Israel,99,459,0,558
2012,Enero,Islas Aland/Provincia de Finlandia,1,0,0,1
2012,Enero,Isla Wake,0,1,0,1
2012,Enero,Italia,726,2431,0,3157
2012,Enero,Islas del Canal,0,1,0,1
2012,Enero,Jamaica,22,24,0,46
2012,Enero,Islas Marianas del Norte,0,1,0,1
2012,Enero,Japón,150,493,0,643
2012,Enero,Jordania,1,1,0,2
2012,Enero,Kazajistán,1,1,0,2
2012,Enero,Kenia,7,14,0,21
2012,Enero,Kuwait,0,1,0,1
2012,Enero,Letonia,13,10,0,23
2012,Enero,Lituania,7,12,0,19
2012,Enero,Líbano,14,39,0,53
2012,Enero,Libia,0,1,0,1
2012,Enero,Liechtenstein,1,4,0,5
2012,Enero,Luxemburgo,1,9,0,10
2012,Enero,Macedonia,0,1,0,1
2012,Enero,Malasia,13,17,0,30
2012,Enero,Malta,2,3,0,5
2012,Enero,Marruecos,2,6,0,8
2012,Enero,Mauricio,1,2,0,3
2012,Enero,México,1959,4197,0,6156
2012,Enero,República de Moldavia,3,0,0,3
2012,Enero,Mónaco,1,1,0,2
2012,Enero,Myanmar,1,0,0,1
2012,Enero,Namibia,0,1,0,1
2012,Enero,Nepal,0,4,0,4
2012,Enero,Nicaragua,59,75,0,134
2012,Enero,Nigeria,2,15,0,17
2012,Enero,Noruega,89,182,0,271
2012,Enero,Nueva Zelanda,47,86,0,133
2012,Enero,Pakistán,1,19,0,20
2012,Enero,Panamá,970,1430,0,2400
2012,Enero,Paraguay,111,127,0,238
2012,Enero,Perú,2627,3954,0,6581
2012,Enero,Palestina,2,3,0,5
2012,Enero,Polonia,110,167,0,277
2012,Enero,Portugal,96,295,0,391
2012,Enero,Puerto Rico/Territorio de Estados Unidos,0,1,0,1
2012,Enero,Reino Unido de Gran Bretaña e Irlanda del Norte,603,1502,0,2105
2012,Enero,República CentroÁfricana,0,1,0,1
2012,Enero,Federación de Rusia,296,405,0,701
2012,Enero,República Dominicana,237,430,0,667
2012,Enero,República Democrática Popular de Corea,1,1,0,2
2012,Enero,Rumania,31,65,0,96
2012,Enero,Rwanda,1,1,0,2
2012,Enero,San Marino,0,3,0,3
2012,Enero,San  Vicente y las Granadinas,0,2,0,2
2012,Enero,Santa Lucia,2,3,0,5
2012,Enero,Santa Sede/Ciudad del Vaticano,0,2,0,2
2012,Enero,Santo Tomé y Príncipe,0,1,0,1
2012,Enero,Senegal,1,0,0,1
2012,Enero,Serbia,2,7,0,9
2012,Enero,Sierra Leona,0,1,0,1
2012,Enero,Singapur,9,16,0,25
2012,Enero,República Árabe Siria,1,5,0,6
2012,Enero,Sri Lanka,0,2,0,2
2012,Enero,Sudáfrica,30,84,0,114
2012,Enero,Sudán,2,2,0,4
2012,Enero,Suecia,245,389,0,634
2012,Enero,Suiza,408,667,0,1075
2012,Enero,Surinam,16,20,0,36
2012,Enero,Taiwán,47,46,0,93
2012,Enero,Tailandia,5,3,0,8
2012,Enero,Territorio Antártico Británico/Territorio Británico de Ultramar,1,7,0,8
2012,Enero,Tanzania,1,2,0,3
2012,Enero,República Democrática de Timor Oriental,0,1,0,1
2012,Enero,Togo,0,1,0,1
2012,Enero,Trinidad y Tobago,23,60,0,83
2012,Enero,Túnez,0,2,0,2
2012,Enero,Turkmenistán,1,0,0,1
2012,Enero,Turquía,26,115,0,141
2012,Enero,Ucrania,31,30,0,61
2012,Enero,Uganda,2,7,0,9
2012,Enero,Uruguay,301,403,0,704
2012,Enero,Uzbekistán,0,1,0,1
2012,Enero,Venezuela,9716,11543,0,21259
2012,Enero,Vietnam,1,1,0,2
2012,Enero,Yugoslavia,1,3,0,4
2012,Enero,Zimbabue,0,2,0,2
2012,Enero,Desconocido,0,1,0,1
2012,Febrero,Albania,0,1,0,1
2012,Febrero,Alemania,1483,2473,0,3956
2012,Febrero,Andorra,1,4,0,5
2012,Febrero,Angola,4,0,0,4
2012,Febrero,Antigua y Barbuda,1,2,0,3
2012,Febrero,Países Bajos,818,1397,0,2215
2012,Febrero,Arabia Saudita,0,3,0,3
2012,Febrero,Argelia,0,2,0,2
2012,Febrero,Argentina,4364,5728,0,10092
2012,Febrero,República de Armenia,0,5,0,5
2012,Febrero,Aruba,0,2,0,2
2012,Febrero,Australia,291,553,0,844
2012,Febrero,Austria,160,286,0,446
2012,Febrero,Azerbaiyán,2,0,0,2
2012,Febrero,Bahamas,6,17,0,23
2012,Febrero,Bahréin,1,0,0,1
2012,Febrero,Bangladesh,0,3,0,3
2012,Febrero,Barbados,5,4,0,9
2012,Febrero,República de Belarús,5,1,0,6
2012,Febrero,Bélgica,143,371,0,514
2012,Febrero,Belice,2,7,0,9
2012,Febrero,Benín,2,2,0,4
2012,Febrero,Bolivia,303,473,0,776
2012,Febrero,Bosnia y Herzegovina,0,3,0,3
2012,Febrero,Brasil,3326,4502,0,7828
2012,Febrero,Bulgaria,7,8,0,15
2012,Febrero,Burundi,0,1,0,1
2012,Febrero,Islas Caimán/Territorio Británico de Ultramar,1,0,0,1
2012,Febrero,Camboya,0,2,0,2
2012,Febrero,Camerún,1,2,0,3
2012,Febrero,Canadá,2489,3307,0,5796
2012,Febrero,España,2088,5237,0,7325
2012,Febrero,República Democrática del Congo,3,1,0,4
2012,Febrero,República de Corea,115,447,0,562
2012,Febrero,Costa de Marfil,1,0,0,1
2012,Febrero,Costa Rica,703,981,0,1684
2012,Febrero,Croacia,5,39,0,44
2012,Febrero,Cuba,99,239,0,338
2012,Febrero,Curazao,1,3,0,4
2012,Febrero,República Checa,35,66,0,101
2012,Febrero,Chile,3625,4281,0,7906
2012,Febrero,China,151,470,0,621
2012,Febrero,Chipre,0,1,0,1
2012,Febrero,Dinamarca,58,156,0,214
2012,Febrero,República de Yibuti,0,1,0,1
2012,Febrero,Dominica,5,5,0,10
2012,Febrero,Ecuador,4036,5379,0,9415
2012,Febrero,Egipto,5,19,0,24
2012,Febrero,El Salvador,437,647,0,1084
2012,Febrero,Emiratos Árabes,1,3,0,4
2012,Febrero,Eslovaquia,20,18,0,38
2012,Febrero,Eslovenia,19,29,0,48
2012,Febrero,Estados Unidos de América,8240,17133,0,25373
2012,Febrero,Estonia,24,20,0,44
2012,Febrero,Etiopia,0,3,0,3
2012,Febrero,Filipinas,21,216,0,237
2012,Febrero,Finlandia,229,252,0,481
2012,Febrero,Francia,1256,2108,0,3364
2012,Febrero,Gabón,0,1,0,1
2012,Febrero,Gambia,0,1,0,1
2012,Febrero,Ghana,2,6,0,8
2012,Febrero,Granada,1,2,0,3
2012,Febrero,Grecia,33,80,0,113
2012,Febrero,Guatemala,177,523,0,700
2012,Febrero,Guyana,2,12,0,14
2012,Febrero,Haití,1,16,0,17
2012,Febrero,Honduras,147,238,0,385
2012,Febrero,Hungría,42,45,0,87
2012,Febrero,India,26,342,0,368
2012,Febrero,Indonesia,9,22,0,31
2012,Febrero,Irán,4,16,0,20
2012,Febrero,República de Irlanda,56,112,0,168
2012,Febrero,Islandia,9,13,0,22
2012,Febrero,Isla de Man,65,218,0,283
2012,Febrero,Isla Johnston,2,1,0,3
2012,Febrero,Israel,128,573,0,701
2012,Febrero,Islas Aland/Provincia de Finlandia,0,1,0,1
2012,Febrero,Isla Wake,1,0,0,1
2012,Febrero,Italia,621,2029,0,2650
2012,Febrero,Jamaica,14,26,0,40
2012,Febrero,Islas Salomón,1,0,0,1
2012,Febrero,Papúa Occidental,1,0,0,1
2012,Febrero,Japón,186,500,0,686
2012,Febrero,Jordania,2,4,0,6
2012,Febrero,Kazajistán,4,1,0,5
2012,Febrero,Kenia,0,16,0,16
2012,Febrero,Kirguistán,0,1,0,1
2012,Febrero,Kuwait,1,0,0,1
2012,Febrero,República de Kosovo,1,0,0,1
2012,Febrero,Lesoto,0,1,0,1
2012,Febrero,Letonia,6,4,0,10
2012,Febrero,Lituania,16,15,0,31
2012,Febrero,Líbano,20,38,0,58
2012,Febrero,Liechtenstein,1,4,0,5
2012,Febrero,Luxemburgo,4,13,0,17
2012,Febrero,Macedonia,1,0,0,1
2012,Febrero,Madagascar,1,0,0,1
2012,Febrero,Malasia,9,26,0,35
2012,Febrero,Malta,1,2,0,3
2012,Febrero,Marruecos,1,9,0,10
2012,Febrero,Mauricio,1,0,0,1
2012,Febrero,México,1692,4388,0,6080
2012,Febrero,República de Moldavia,2,0,0,2
2012,Febrero,Mongolia,1,0,0,1
2012,Febrero,Mozambique,0,1,0,1
2012,Febrero,Myanmar,1,1,0,2
2012,Febrero,Nicaragua,72,69,0,141
2012,Febrero,Nigeria,3,6,0,9
2012,Febrero,Noruega,120,201,0,321
2012,Febrero,Nueva Zelanda,36,101,0,137
2012,Febrero,Papúa Nueva Guinea,0,1,0,1
2012,Febrero,Pakistán,0,9,0,9
2012,Febrero,Panamá,1045,1533,0,2578
2012,Febrero,Paraguay,101,128,0,229
2012,Febrero,Perú,3715,4638,0,8353
2012,Febrero,Palestina,0,3,0,3
2012,Febrero,Polonia,111,235,0,346
2012,Febrero,Portugal,86,271,0,357
2012,Febrero,Puerto Rico/Territorio de Estados Unidos,0,3,0,3
2012,Febrero,Reino Unido de Gran Bretaña e Irlanda del Norte,531,1286,0,1817
2012,Febrero,República CentroÁfricana,1,1,0,2
2012,Febrero,Federación de Rusia,200,249,0,449
2012,Febrero,República Dominicana,268,499,0,767
2012,Febrero,Rumania,40,59,0,99
2012,Febrero,Rwanda,0,1,0,1
2012,Febrero,San Cristóbal y Nevis,1,2,0,3
2012,Febrero,Samoa Occidental,1,0,0,1
2012,Febrero,San Marino,0,2,0,2
2012,Febrero,San  Vicente y las Granadinas,2,1,0,3
2012,Febrero,Santa Lucia,2,3,0,5
2012,Febrero,Senegal,1,0,0,1
2012,Febrero,Serbia,8,9,0,17
2012,Febrero,Singapur,1,15,0,16
2012,Febrero,República Árabe Siria,0,1,0,1
2012,Febrero,Sri Lanka,0,3,0,3
2012,Febrero,Sudáfrica,16,82,0,98
2012,Febrero,Sudán,0,2,0,2
2012,Febrero,Suecia,238,308,0,546
2012,Febrero,Suiza,392,663,0,1055
2012,Febrero,Surinam,13,14,0,27
2012,Febrero,Taiwán,46,76,0,122
2012,Febrero,Tailandia,4,2,0,6
2012,Febrero,Tíbet/Región Autónoma de China,0,1,0,1
2012,Febrero,Territorio Antártico Británico/Territorio Británico de Ultramar,1,6,0,7
2012,Febrero,Tanzania,2,5,0,7
2012,Febrero,Trinidad y Tobago,20,51,0,71
2012,Febrero,Túnez,0,1,0,1
2012,Febrero,Turquía,25,84,0,109
2012,Febrero,Ucrania,21,30,0,51
2012,Febrero,Uganda,0,4,0,4
2012,Febrero,Uruguay,358,485,0,843
2012,Febrero,Venezuela,8489,10738,0,19227
2012,Febrero,Vietnam,4,1,0,5
2012,Febrero,Yugoslavia,0,1,0,1
2012,Febrero,Zambia,1,3,0,4
2012,Febrero,Zimbabue,1,1,0,2
2012,Febrero,Desconocido,0,1,0,1
2012,Marzo,Albania,1,0,0,1
2012,Marzo,Alemania,1604,2586,0,4190
2012,Marzo,Andorra,1,10,0,11
2012,Marzo,Angola,1,2,0,3
2012,Marzo,Antigua y Barbuda,2,1,0,3
2012,Marzo,Países Bajos,816,1438,0,2254
2012,Marzo,Arabia Saudita,1,3,0,4
2012,Marzo,Argelia,0,1,0,1
2012,Marzo,Argentina,4472,5863,0,10335
2012,Marzo,República de Armenia,0,2,0,2
2012,Marzo,Aruba,4,4,0,8
2012,Marzo,Australia,286,538,0,824
2012,Marzo,Austria,117,226,0,343
2012,Marzo,Azerbaiyán,1,2,0,3
2012,Marzo,Bahamas,2,16,0,18
2012,Marzo,Bahréin,0,1,0,1
2012,Marzo,Bangladesh,2,1,0,3
2012,Marzo,Barbados,4,7,0,11
2012,Marzo,República de Belarús,4,0,0,4
2012,Marzo,Bélgica,138,354,0,492
2012,Marzo,Belice,3,9,0,12
2012,Marzo,Benín,0,1,0,1
2012,Marzo,Bermudas/Territorio Británico de Ultramar,0,6,0,6
2012,Marzo,Bolivia,382,488,0,870
2012,Marzo,Bosnia y Herzegovina,0,2,0,2
2012,Marzo,Brasil,2229,4058,0,6287
2012,Marzo,Bulgaria,2,11,0,13
2012,Marzo,Islas Caimán/Territorio Británico de Ultramar,1,2,0,3
2012,Marzo,Camboya,1,2,0,3
2012,Marzo,Camerún,0,4,0,4
2012,Marzo,Canadá,2597,3274,0,5871
2012,Marzo,España,2268,5384,0,7652
2012,Marzo,República Democrática del Congo,3,6,0,9
2012,Marzo,República de Corea,117,497,0,614
2012,Marzo,Costa de Marfil,0,2,0,2
2012,Marzo,Costa Rica,812,1089,0,1901
2012,Marzo,Croacia,8,62,0,70
2012,Marzo,Cuba,103,218,0,321
2012,Marzo,Curazao,5,4,0,9
2012,Marzo,República Checa,47,73,0,120
2012,Marzo,Chile,2459,3687,0,6146
2012,Marzo,China,168,484,0,652
2012,Marzo,Chipre,0,5,0,5
2012,Marzo,Dinamarca,76,188,0,264
2012,Marzo,Dominica,1,10,0,11
2012,Marzo,Ecuador,3625,5558,0,9183
2012,Marzo,Egipto,4,13,0,17
2012,Marzo,El Salvador,424,578,0,1002
2012,Marzo,Emiratos Árabes,1,24,0,25
2012,Marzo,Eslovaquia,25,16,0,41
2012,Marzo,Eslovenia,17,36,0,53
2012,Marzo,Estados Unidos de América,9331,18243,0,27574
2012,Marzo,Estonia,24,21,0,45
2012,Marzo,Etiopia,2,7,0,9
2012,Marzo,Filipinas,21,184,0,205
2012,Marzo,Finlandia,149,161,0,310
2012,Marzo,Francia,972,2016,0,2988
2012,Marzo,Georgia,9,16,0,25
2012,Marzo,Ghana,2,3,0,5
2012,Marzo,Grecia,23,71,0,94
2012,Marzo,Guatemala,270,591,0,861
2012,Marzo,Guyana,3,27,0,30
2012,Marzo,Guinea Ecuatorial,1,0,0,1
2012,Marzo,Guinea Bissau,0,1,0,1
2012,Marzo,Haití,8,31,0,39
2012,Marzo,Honduras,190,266,0,456
2012,Marzo,Hungría,28,39,0,67
2012,Marzo,India,55,275,0,330
2012,Marzo,Indonesia,9,44,0,53
2012,Marzo,Iraq,0,2,0,2
2012,Marzo,Irán,6,16,0,22
2012,Marzo,República de Irlanda,57,144,0,201
2012,Marzo,Islandia,7,4,0,11
2012,Marzo,Isla de Man,110,284,0,394
2012,Marzo,Isla Johnston,0,1,0,1
2012,Marzo,Israel,101,548,0,649
2012,Marzo,Islas Aland/Provincia de Finlandia,0,1,0,1
2012,Marzo,Italia,530,2116,0,2646
2012,Marzo,Islas del Canal,1,1,0,2
2012,Marzo,Jamaica,10,29,0,39
2012,Marzo,Japón,255,571,0,826
2012,Marzo,Jordania,3,9,0,12
2012,Marzo,Kazajistán,2,3,0,5
2012,Marzo,Kenia,4,9,0,13
2012,Marzo,Kirguistán,0,1,0,1
2012,Marzo,Kuwait,0,3,0,3
2012,Marzo,República de Kosovo,6,14,0,20
2012,Marzo,Letonia,8,17,0,25
2012,Marzo,Lituania,10,14,0,24
2012,Marzo,Líbano,16,45,0,61
2012,Marzo,Liberia,0,1,0,1
2012,Marzo,Liechtenstein,4,3,0,7
2012,Marzo,Luxemburgo,8,20,0,28
2012,Marzo,Macedonia,1,4,0,5
2012,Marzo,Madagascar,0,2,0,2
2012,Marzo,Malasia,7,22,0,29
2012,Marzo,Malawi,2,0,0,2
2012,Marzo,Malta,1,6,0,7
2012,Marzo,Marruecos,6,10,0,16
2012,Marzo,Mauricio,0,1,0,1
2012,Marzo,México,1942,4690,0,6632
2012,Marzo,República de Moldavia,2,0,0,2
2012,Marzo,Mónaco,0,1,0,1
2012,Marzo,Mozambique,1,1,0,2
2012,Marzo,Myanmar,1,0,0,1
2012,Marzo,Namibia,0,1,0,1
2012,Marzo,Nepal,0,4,0,4
2012,Marzo,Nicaragua,61,96,0,157
2012,Marzo,Nigeria,2,5,0,7
2012,Marzo,Noruega,94,176,0,270
2012,Marzo,Nueva Caledonia/Territorio francés,0,1,0,1
2012,Marzo,Nueva Zelanda,49,97,0,146
2012,Marzo,Omán,0,2,0,2
2012,Marzo,Pakistán,2,26,0,28
2012,Marzo,Panamá,821,1564,0,2385
2012,Marzo,Paraguay,59,104,0,163
2012,Marzo,Perú,3228,4747,0,7975
2012,Marzo,Palestina,0,3,0,3
2012,Marzo,Polonia,100,189,0,289
2012,Marzo,Portugal,92,278,0,370
2012,Marzo,Puerto Rico/Territorio de Estados Unidos,2,4,0,6
2012,Marzo,Reino Unido de Gran Bretaña e Irlanda del Norte,628,1467,0,2095
2012,Marzo,República CentroÁfricana,0,4,0,4
2012,Marzo,Federación de Rusia,176,249,0,425
2012,Marzo,República Dominicana,320,462,0,782
2012,Marzo,Rumania,46,95,0,141
2012,Marzo,San Cristóbal y Nevis,0,2,0,2
2012,Marzo,San Marino,0,1,0,1
2012,Marzo,San  Vicente y las Granadinas,1,2,0,3
2012,Marzo,Santa Lucia,5,11,0,16
2012,Marzo,Santa Sede/Ciudad del Vaticano,0,1,0,1
2012,Marzo,Senegal,1,2,0,3
2012,Marzo,Serbia,16,20,0,36
2012,Marzo,Sierra Leona,0,1,0,1
2012,Marzo,Singapur,13,17,0,30
2012,Marzo,República Árabe Siria,1,4,0,5
2012,Marzo,Sri Lanka,0,1,0,1
2012,Marzo,Sudáfrica,39,91,0,130
2012,Marzo,Sudán,0,1,0,1
2012,Marzo,Suecia,177,327,0,504
2012,Marzo,Suiza,329,646,0,975
2012,Marzo,Surinam,6,19,0,25
2012,Marzo,Suazilandia,1,0,0,1
2012,Marzo,Taiwán,23,61,0,84
2012,Marzo,República de Tayikistán,1,0,0,1
2012,Marzo,Tailandia,5,2,0,7
2012,Marzo,Territorio Antártico Británico/Territorio Británico de Ultramar,1,4,0,5
2012,Marzo,Tanzania,2,1,0,3
2012,Marzo,Togo,0,1,0,1
2012,Marzo,Trinidad y Tobago,27,106,0,133
2012,Marzo,Túnez,1,6,0,7
2012,Marzo,Turquía,22,95,0,117
2012,Marzo,Ucrania,29,30,0,59
2012,Marzo,Uganda,1,4,0,5
2012,Marzo,Uruguay,335,492,0,827
2012,Marzo,Uzbekistán,2,0,0,2
2012,Marzo,Venezuela,7666,10026,0,17692
2012,Marzo,Vietnam,2,2,0,4
2012,Marzo,Yugoslavia,1,0,0,1
2012,Marzo,Zambia,0,1,0,1
2012,Marzo,Zimbabue,1,3,0,4
2012,Abril,Albania,3,4,0,7
2012,Abril,Alemania,943,1748,0,2691
2012,Abril,Andorra,1,7,0,8
2012,Abril,Angola,0,2,0,2
2012,Abril,Antigua y Barbuda,2,2,0,4
2012,Abril,Países Bajos,855,1436,0,2291
2012,Abril,Arabia Saudita,0,5,0,5
2012,Abril,Argelia,1,3,0,4
2012,Abril,Argentina,4095,5380,0,9475
2012,Abril,República de Armenia,1,1,0,2
2012,Abril,Aruba,1,2,0,3
2012,Abril,Australia,280,501,0,781
2012,Abril,Austria,89,194,0,283
2012,Abril,Azerbaiyán,1,2,0,3
2012,Abril,Bahamas,3,15,0,18
2012,Abril,Bangladesh,0,3,0,3
2012,Abril,Barbados,12,12,0,24
2012,Abril,República de Belarús,1,3,0,4
2012,Abril,Bélgica,101,292,0,393
2012,Abril,Belice,5,13,0,18
2012,Abril,Bolivia,325,469,0,794
2012,Abril,Bosnia y Herzegovina,0,2,0,2
2012,Abril,Brasil,2837,4315,0,7152
2012,Abril,Bulgaria,8,9,0,17
2012,Abril,Burkina Faso,0,1,0,1
2012,Abril,Islas Caimán/Territorio Británico de Ultramar,0,2,0,2
2012,Abril,Camerún,0,2,0,2
2012,Abril,Canadá,1032,1878,0,2910
2012,Abril,España,2055,4803,0,6858
2012,Abril,República Democrática del Congo,1,1,0,2
2012,Abril,República de Corea,186,444,0,630
2012,Abril,Costa de Marfil,0,2,0,2
2012,Abril,Costa Rica,858,1106,0,1964
2012,Abril,Croacia,6,45,0,51
2012,Abril,Cuba,122,259,0,381
2012,Abril,Curazao,1,6,0,7
2012,Abril,República Checa,31,31,0,62
2012,Abril,Chile,2254,3484,0,5738
2012,Abril,China,169,550,0,719
2012,Abril,Chipre,3,3,0,6
2012,Abril,Dinamarca,61,151,0,212
2012,Abril,Dominica,4,12,0,16
2012,Abril,Ecuador,3324,4804,0,8128
2012,Abril,Egipto,4,17,0,21
2012,Abril,El Salvador,404,627,0,1031
2012,Abril,Emiratos Árabes,0,7,0,7
2012,Abril,Eslovaquia,19,32,0,51
2012,Abril,Eslovenia,9,39,0,48
2012,Abril,Estados Unidos de América,7245,15879,0,23124
2012,Abril,Estonia,5,5,0,10
2012,Abril,Etiopia,0,3,0,3
2012,Abril,Filipinas,16,127,0,143
2012,Abril,Finlandia,41,78,0,119
2012,Abril,Francia,1027,1917,0,2944
2012,Abril,Georgia,0,1,0,1
2012,Abril,Granada,3,8,0,11
2012,Abril,Grecia,8,51,0,59
2012,Abril,Guatemala,232,520,0,752
2012,Abril,Guyana,6,15,0,21
2012,Abril,Guinea,1,1,0,2
2012,Abril,Guayana Francesa/Departamento de Ultramar Francés,0,1,0,1
2012,Abril,Haití,8,27,0,35
2012,Abril,Honduras,163,262,0,425
2012,Abril,Hungría,11,26,0,37
2012,Abril,India,37,241,0,278
2012,Abril,Indonesia,7,87,0,94
2012,Abril,Irán,2,14,0,16
2012,Abril,República de Irlanda,51,118,0,169
2012,Abril,Islandia,4,3,0,7
2012,Abril,Isla de Man,91,240,0,331
2012,Abril,Isla Johnston,0,2,0,2
2012,Abril,Israel,123,644,0,767
2012,Abril,Islas Aland/Provincia de Finlandia,0,1,0,1
2012,Abril,Italia,415,1595,0,2010
2012,Abril,Jamaica,21,37,0,58
2012,Abril,Japón,142,449,0,591
2012,Abril,Jordania,2,1,0,3
2012,Abril,Kazajistán,2,3,0,5
2012,Abril,Kenia,0,8,0,8
2012,Abril,Kirguistán,0,1,0,1
2012,Abril,Kuwait,0,1,0,1
2012,Abril,República de Kosovo,1,0,0,1
2012,Abril,Letonia,4,6,0,10
2012,Abril,Lituania,11,16,0,27
2012,Abril,Líbano,19,34,0,53
2012,Abril,Liechtenstein,2,3,0,5
2012,Abril,Luxemburgo,4,9,0,13
2012,Abril,Macedonia,1,1,0,2
2012,Abril,Madagascar,1,0,0,1
2012,Abril,Malasia,7,22,0,29
2012,Abril,Malawi,0,1,0,1
2012,Abril,Malta,0,5,0,5
2012,Abril,Marruecos,4,6,0,10
2012,Abril,Mauricio,0,1,0,1
2012,Abril,México,2061,4698,0,6759
2012,Abril,Mónaco,1,1,0,2
2012,Abril,Montenegro,0,1,0,1
2012,Abril,Mozambique,1,1,0,2
2012,Abril,Namibia,1,1,0,2
2012,Abril,Nepal,1,3,0,4
2012,Abril,Nicaragua,56,96,0,152
2012,Abril,Nigeria,0,7,0,7
2012,Abril,Níger,0,1,0,1
2012,Abril,Noruega,61,128,0,189
2012,Abril,Nueva Zelanda,53,88,0,141
2012,Abril,Pakistán,6,17,0,23
2012,Abril,Panamá,807,1444,0,2251
2012,Abril,Paraguay,98,100,0,198
2012,Abril,Perú,2873,3956,0,6829
2012,Abril,Palestina,1,2,0,3
2012,Abril,Polonia,74,161,0,235
2012,Abril,Portugal,81,272,0,353
2012,Abril,Puerto Rico/Territorio de Estados Unidos,0,5,0,5
2012,Abril,Reino Unido de Gran Bretaña e Irlanda del Norte,482,1302,0,1784
2012,Abril,Federación de Rusia,162,255,0,417
2012,Abril,República Dominicana,301,435,0,736
2012,Abril,Rumania,46,79,0,125
2012,Abril,San Cristóbal y Nevis,2,3,0,5
2012,Abril,San Marino,1,3,0,4
2012,Abril,San  Vicente y las Granadinas,2,4,0,6
2012,Abril,Santa Lucia,4,7,0,11
2012,Abril,Santa Sede/Ciudad del Vaticano,1,0,0,1
2012,Abril,Senegal,0,1,0,1
2012,Abril,Serbia,1,5,0,6
2012,Abril,Singapur,7,17,0,24
2012,Abril,República Árabe Siria,0,3,0,3
2012,Abril,Sri Lanka,0,2,0,2
2012,Abril,Sudáfrica,20,74,0,94
2012,Abril,Sudán,2,6,0,8
2012,Abril,Suecia,172,257,0,429
2012,Abril,Suiza,305,569,0,874
2012,Abril,Surinam,34,39,0,73
2012,Abril,Taiwán,52,98,0,150
2012,Abril,Tailandia,3,6,0,9
2012,Abril,Territorio Antártico Británico/Territorio Británico de Ultramar,0,4,0,4
2012,Abril,Tanzania,0,1,0,1
2012,Abril,Trinidad y Tobago,26,122,0,148
2012,Abril,Túnez,0,5,0,5
2012,Abril,Turquía,13,46,0,59
2012,Abril,Ucrania,25,26,0,51
2012,Abril,Uganda,1,2,0,3
2012,Abril,Uruguay,337,536,0,873
2012,Abril,Venezuela,9215,10724,0,19939
2012,Abril,Vietnam,0,17,0,17
2012,Abril,República Árabe de Yemen,0,1,0,1
2012,Abril,Yugoslavia,1,0,0,1
2012,Mayo,Afganistán,0,1,0,1
2012,Mayo,Albania,1,1,0,2
2012,Mayo,Alemania,954,1744,0,2698
2012,Mayo,Andorra,1,9,0,10
2012,Mayo,Angola,0,3,0,3
2012,Mayo,Países Bajos,724,1261,0,1985
2012,Mayo,Arabia Saudita,0,3,0,3
2012,Mayo,Argelia,1,4,0,5
2012,Mayo,Argentina,3507,4942,0,8449
2012,Mayo,Aruba,1,4,0,5
2012,Mayo,Australia,275,547,0,822
2012,Mayo,Austria,80,181,0,261
2012,Mayo,Bahamas,3,16,0,19
2012,Mayo,Bangladesh,1,0,0,1
2012,Mayo,Barbados,2,6,0,8
2012,Mayo,República de Belarús,0,3,0,3
2012,Mayo,Bélgica,79,264,0,343
2012,Mayo,Belice,2,5,0,7
2012,Mayo,Benín,2,0,0,2
2012,Mayo,Bermudas/Territorio Británico de Ultramar,0,1,0,1
2012,Mayo,Bolivia,307,450,0,757
2012,Mayo,Bosnia y Herzegovina,1,1,0,2
2012,Mayo,Botsuana,0,1,0,1
2012,Mayo,Brasil,2601,4325,0,6926
2012,Mayo,Bulgaria,8,10,0,18
2012,Mayo,Burkina Faso,0,1,0,1
2012,Mayo,Cabo Verde,0,1,0,1
2012,Mayo,Islas Caimán/Territorio Británico de Ultramar,3,1,0,4
2012,Mayo,Camboya,0,1,0,1
2012,Mayo,Camerún,0,2,0,2
2012,Mayo,Canadá,693,1581,0,2274
2012,Mayo,España,1859,5034,0,6893
2012,Mayo,República Democrática del Congo,1,1,0,2
2012,Mayo,República de Corea,160,415,0,575
2012,Mayo,Costa de Marfil,0,3,0,3
2012,Mayo,Costa Rica,641,924,0,1565
2012,Mayo,Croacia,5,35,0,40
2012,Mayo,Cuba,91,240,0,331
2012,Mayo,Curazao,3,4,0,7
2012,Mayo,República Checa,26,52,0,78
2012,Mayo,Chile,2509,3718,0,6227
2012,Mayo,China,182,590,0,772
2012,Mayo,Chipre,3,3,0,6
2012,Mayo,Dinamarca,58,103,0,161
2012,Mayo,Dominica,3,5,0,8
2012,Mayo,Ecuador,3030,5099,0,8129
2012,Mayo,Egipto,6,19,0,25
2012,Mayo,El Salvador,346,607,0,953
2012,Mayo,Emiratos Árabes,2,9,0,11
2012,Mayo,Eslovaquia,15,11,0,26
2012,Mayo,Eslovenia,6,25,0,31
2012,Mayo,Estados Unidos de América,8768,17372,0,26140
2012,Mayo,Estonia,4,8,0,12
2012,Mayo,Etiopia,2,0,0,2
2012,Mayo,Islas Fiji,1,0,0,1
2012,Mayo,Filipinas,22,141,0,163
2012,Mayo,Finlandia,50,70,0,120
2012,Mayo,Francia,792,1686,0,2478
2012,Mayo,Gabón,0,1,0,1
2012,Mayo,Georgia,2,2,0,4
2012,Mayo,Ghana,2,11,0,13
2012,Mayo,Granada,1,0,0,1
2012,Mayo,Grecia,13,49,0,62
2012,Mayo,Guatemala,233,524,0,757
2012,Mayo,Guyana,6,34,0,40
2012,Mayo,Guinea,0,1,0,1
2012,Mayo,Guinea Ecuatorial,1,0,0,1
2012,Mayo,Guayana Francesa/Departamento de Ultramar Francés,0,3,0,3
2012,Mayo,Haití,1,15,0,16
2012,Mayo,Honduras,143,243,0,386
2012,Mayo,Hong Kong,0,1,0,1
2012,Mayo,Hungría,19,27,0,46
2012,Mayo,India,57,301,0,358
2012,Mayo,Indonesia,10,16,0,26
2012,Mayo,Iraq,0,1,0,1
2012,Mayo,Irán,3,21,0,24
2012,Mayo,República de Irlanda,59,126,0,185
2012,Mayo,Islandia,8,6,0,14
2012,Mayo,Isla de Man,93,189,0,282
2012,Mayo,Isla Johnston,0,2,0,2
2012,Mayo,Israel,160,750,0,910
2012,Mayo,Italia,435,1519,0,1954
2012,Mayo,Jamaica,11,33,0,44
2012,Mayo,Japón,164,498,0,662
2012,Mayo,Jordania,3,7,0,10
2012,Mayo,Kazajistán,5,3,0,8
2012,Mayo,Kenia,4,8,0,12
2012,Mayo,Kirguistán,1,0,0,1
2012,Mayo,Kuwait,0,4,0,4
2012,Mayo,Lesoto,1,0,0,1
2012,Mayo,Letonia,4,8,0,12
2012,Mayo,Lituania,9,10,0,19
2012,Mayo,Líbano,13,34,0,47
2012,Mayo,Liechtenstein,0,2,0,2
2012,Mayo,Luxemburgo,4,4,0,8
2012,Mayo,Macedonia,1,1,0,2
2012,Mayo,Malasia,12,28,0,40
2012,Mayo,Malawi,1,0,0,1
2012,Mayo,Malta,2,5,0,7
2012,Mayo,Marruecos,2,5,0,7
2012,Mayo,Mauricio,1,0,0,1
2012,Mayo,Mauritania,0,1,0,1
2012,Mayo,México,1993,4599,0,6592
2012,Mayo,República de Moldavia,2,1,0,3
2012,Mayo,Mónaco,0,1,0,1
2012,Mayo,Mongolia,1,1,0,2
2012,Mayo,Mozambique,0,3,0,3
2012,Mayo,Myanmar,0,1,0,1
2012,Mayo,Nepal,0,8,0,8
2012,Mayo,Nicaragua,76,70,0,146
2012,Mayo,Nigeria,1,4,0,5
2012,Mayo,Níger,1,1,0,2
2012,Mayo,Noruega,55,86,0,141
2012,Mayo,Nueva Zelanda,58,110,0,168
2012,Mayo,Omán,1,1,0,2
2012,Mayo,Pakistán,1,17,0,18
2012,Mayo,Panamá,735,1406,0,2141
2012,Mayo,Paraguay,72,93,0,165
2012,Mayo,Perú,3139,4153,0,7292
2012,Mayo,Polonia,52,80,0,132
2012,Mayo,Portugal,74,336,0,410
2012,Mayo,Puerto Rico/Territorio de Estados Unidos,2,1,0,3
2012,Mayo,Qatar,1,1,0,2
2012,Mayo,Reino Unido de Gran Bretaña e Irlanda del Norte,507,1297,0,1804
2012,Mayo,Federación de Rusia,115,183,0,298
2012,Mayo,República Dominicana,297,459,0,756
2012,Mayo,Rumania,56,73,0,129
2012,Mayo,San Cristóbal y Nevis,0,3,0,3
2012,Mayo,San  Vicente y las Granadinas,1,2,0,3
2012,Mayo,Santa Lucia,5,2,0,7
2012,Mayo,Santa Sede/Ciudad del Vaticano,0,1,0,1
2012,Mayo,Senegal,1,2,0,3
2012,Mayo,Serbia,1,2,0,3
2012,Mayo,Sierra Leona,0,1,0,1
2012,Mayo,Singapur,12,17,0,29
2012,Mayo,República Árabe Siria,4,0,0,4
2012,Mayo,Sri Lanka,0,3,0,3
2012,Mayo,Sudáfrica,46,100,0,146
2012,Mayo,Sudán,1,2,0,3
2012,Mayo,Suecia,147,229,0,376
2012,Mayo,Suiza,251,496,0,747
2012,Mayo,Surinam,7,27,0,34
2012,Mayo,Taiwán,60,81,0,141
2012,Mayo,Tailandia,8,20,0,28
2012,Mayo,Tíbet/Región Autónoma de China,0,1,0,1
2012,Mayo,Territorio Antártico Británico/Territorio Británico de Ultramar,1,6,0,7
2012,Mayo,Tanzania,1,1,0,2
2012,Mayo,Togo,0,1,0,1
2012,Mayo,Trinidad y Tobago,25,125,0,150
2012,Mayo,Túnez,3,4,0,7
2012,Mayo,Turkmenistán,1,0,0,1
2012,Mayo,Turquía,23,83,0,106
2012,Mayo,Ucrania,12,20,0,32
2012,Mayo,Uganda,3,1,0,4
2012,Mayo,Uruguay,309,402,0,711
2012,Mayo,Venezuela,6465,8885,0,15350
2012,Mayo,Vietnam,3,11,0,14
2012,Mayo,Islas Vírgenes Británicas/Territorio Británico de Ultramar,0,1,0,1
2012,Mayo,República Árabe de Yemen,0,1,0,1
2012,Mayo,Yugoslavia,1,1,0,2
2012,Mayo,Zambia,2,1,0,3
2012,Mayo,Zimbabue,0,2,0,2
2012,Mayo,Desconocido,0,1,0,1
2012,Junio,Albania,2,1,0,3
2012,Junio,Alemania,1089,1710,0,2799
2012,Junio,Andorra,0,12,0,12
2012,Junio,Angola,1,3,0,4
2012,Junio,Antigua y Barbuda,0,3,0,3
2012,Junio,Países Bajos,884,1410,0,2294
2012,Junio,Arabia Saudita,0,15,0,15
2012,Junio,Argelia,1,6,0,7
2012,Junio,Argentina,3065,4496,0,7561
2012,Junio,República de Armenia,0,1,0,1
2012,Junio,Aruba,4,3,0,7
2012,Junio,Australia,320,535,0,855
2012,Junio,Austria,109,173,0,282
2012,Junio,Azerbaiyán,0,3,0,3
2012,Junio,Bahamas,6,16,0,22
2012,Junio,Bangladesh,0,3,0,3
2012,Junio,Barbados,2,6,0,8
2012,Junio,República de Belarús,2,5,0,7
2012,Junio,Bélgica,188,395,0,583
2012,Junio,Belice,4,23,0,27
2012,Junio,Benín,1,0,0,1
2012,Junio,Bermudas/Territorio Británico de Ultramar,1,1,0,2
2012,Junio,Bolivia,311,446,0,757
2012,Junio,Bosnia y Herzegovina,1,2,0,3
2012,Junio,Botsuana,0,1,0,1
2012,Junio,Brasil,2259,3850,0,6109
2012,Junio,Brunei Darussalam,1,0,0,1
2012,Junio,Bulgaria,8,8,0,16
2012,Junio,Burkina Faso,1,2,0,3
2012,Junio,Burundi,0,1,0,1
2012,Junio,Bután,0,3,0,3
2012,Junio,Islas Caimán/Territorio Británico de Ultramar,9,10,0,19
2012,Junio,Camboya,0,2,0,2
2012,Junio,Camerún,2,5,0,7
2012,Junio,Canadá,771,1576,0,2347
2012,Junio,Chad,0,1,0,1
2012,Junio,España,2538,5696,0,8234
2012,Junio,República Democrática del Congo,2,5,0,7
2012,Junio,República de Corea,193,766,0,959
2012,Junio,Costa de Marfil,0,2,0,2
2012,Junio,Costa Rica,623,982,0,1605
2012,Junio,Croacia,6,53,0,59
2012,Junio,Cuba,104,197,0,301
2012,Junio,Curazao,6,1,0,7
2012,Junio,República Checa,46,92,0,138
2012,Junio,Chile,2270,3445,0,5715
2012,Junio,China,138,454,0,592
2012,Junio,Chipre,2,5,0,7
2012,Junio,Dinamarca,83,149,0,232
2012,Junio,Dominica,1,3,0,4
2012,Junio,Ecuador,2794,4844,0,7638
2012,Junio,Egipto,2,12,0,14
2012,Junio,El Salvador,345,639,0,984
2012,Junio,Emiratos Árabes,2,7,0,9
2012,Junio,Eritrea,0,1,0,1
2012,Junio,Eslovaquia,10,21,0,31
2012,Junio,Eslovenia,8,18,0,26
2012,Junio,Estados Unidos de América,14348,22490,0,36838
2012,Junio,Estonia,4,6,0,10
2012,Junio,Etiopia,0,5,0,5
2012,Junio,Filipinas,23,152,0,175
2012,Junio,Finlandia,47,69,0,116
2012,Junio,Francia,1063,1888,0,2951
2012,Junio,Gabón,1,2,0,3
2012,Junio,Georgia,1,2,0,3
2012,Junio,Ghana,1,4,0,5
2012,Junio,Granada,0,3,0,3
2012,Junio,Grecia,18,54,0,72
2012,Junio,Guatemala,337,686,0,1023
2012,Junio,Guyana,7,17,0,24
2012,Junio,Guinea,0,1,0,1
2012,Junio,Guinea Ecuatorial,1,0,0,1
2012,Junio,Haití,4,21,0,25
2012,Junio,Honduras,139,326,0,465
2012,Junio,Hungría,18,26,0,44
2012,Junio,India,45,249,0,294
2012,Junio,Indonesia,14,35,0,49
2012,Junio,Irán,7,18,0,25
2012,Junio,República de Irlanda,76,124,0,200
2012,Junio,Islandia,10,3,0,13
2012,Junio,Isla de Man,88,197,0,285
2012,Junio,Israel,149,679,0,828
2012,Junio,Islas Aland/Provincia de Finlandia,0,1,0,1
2012,Junio,Italia,537,1693,0,2230
2012,Junio,Islas del Canal,0,1,0,1
2012,Junio,Jamaica,15,52,0,67
2012,Junio,Islas Salomón,0,1,0,1
2012,Junio,Japón,167,491,0,658
2012,Junio,Jordania,0,5,0,5
2012,Junio,Kazajistán,4,1,0,5
2012,Junio,Kenia,6,22,0,28
2012,Junio,Kuwait,0,7,0,7
2012,Junio,República de Kosovo,1,0,0,1
2012,Junio,República Democrática Popular  Lao,0,2,0,2
2012,Junio,Letonia,5,8,0,13
2012,Junio,Lituania,6,8,0,14
2012,Junio,Líbano,11,37,0,48
2012,Junio,Liberia,0,2,0,2
2012,Junio,Libia,0,3,0,3
2012,Junio,Luxemburgo,3,12,0,15
2012,Junio,Macedonia,3,2,0,5
2012,Junio,Madagascar,1,1,0,2
2012,Junio,Malasia,11,27,0,38
2012,Junio,Malta,2,1,0,3
2012,Junio,Marruecos,3,6,0,9
2012,Junio,Mauricio,0,1,0,1
2012,Junio,Mauritania,0,2,0,2
2012,Junio,México,1924,4471,0,6395
2012,Junio,República de Moldavia,1,0,0,1
2012,Junio,Mónaco,0,1,0,1
2012,Junio,Mongolia,1,0,0,1
2012,Junio,Mozambique,0,2,0,2
2012,Junio,Namibia,0,1,0,1
2012,Junio,Nepal,0,3,0,3
2012,Junio,Nicaragua,68,98,0,166
2012,Junio,Nigeria,4,13,0,17
2012,Junio,Noruega,143,221,0,364
2012,Junio,Nueva Zelanda,62,97,0,159
2012,Junio,Omán,0,1,0,1
2012,Junio,Papúa Nueva Guinea,1,2,0,3
2012,Junio,Pakistán,0,14,0,14
2012,Junio,Panamá,806,1414,0,2220
2012,Junio,Paraguay,168,296,0,464
2012,Junio,Perú,2654,3891,0,6545
2012,Junio,Palestina,1,1,0,2
2012,Junio,Polonia,78,107,0,185
2012,Junio,Portugal,85,361,0,446
2012,Junio,Puerto Rico/Territorio de Estados Unidos,4,12,0,16
2012,Junio,Reino Unido de Gran Bretaña e Irlanda del Norte,591,1252,0,1843
2012,Junio,República CentroÁfricana,0,2,0,2
2012,Junio,Federación de Rusia,128,172,0,300
2012,Junio,República Dominicana,291,474,0,765
2012,Junio,Rumania,17,53,0,70
2012,Junio,Rwanda,1,0,0,1
2012,Junio,San Cristóbal y Nevis,0,6,0,6
2012,Junio,Santa Lucia,2,5,0,7
2012,Junio,Santa Sede/Ciudad del Vaticano,0,1,0,1
2012,Junio,Senegal,0,2,0,2
2012,Junio,Serbia,2,5,0,7
2012,Junio,Sierra Leona,2,0,0,2
2012,Junio,Singapur,7,12,0,19
2012,Junio,República Árabe Siria,0,3,0,3
2012,Junio,Somalia,0,1,0,1
2012,Junio,Sri Lanka,2,0,0,2
2012,Junio,Sudáfrica,22,96,0,118
2012,Junio,Sudán,0,2,0,2
2012,Junio,Suecia,224,283,0,507
2012,Junio,Suiza,352,573,0,925
2012,Junio,Surinam,5,21,0,26
2012,Junio,Taiwán,34,75,0,109
2012,Junio,Tailandia,4,5,0,9
2012,Junio,Tíbet/Región Autónoma de China,0,2,0,2
2012,Junio,Territorio Antártico Británico/Territorio Británico de Ultramar,2,4,0,6
2012,Junio,Tanzania,1,5,0,6
2012,Junio,Trinidad y Tobago,18,113,0,131
2012,Junio,Túnez,2,4,0,6
2012,Junio,Turquía,17,87,0,104
2012,Junio,Ucrania,17,11,0,28
2012,Junio,Uganda,1,3,0,4
2012,Junio,Uruguay,324,510,0,834
2012,Junio,Vanuatu,0,1,0,1
2012,Junio,Venezuela,6595,8956,0,15551
2012,Junio,Vietnam,1,9,0,10
2012,Junio,Islas Vírgenes Británicas/Territorio Británico de Ultramar,0,1,0,1
2012,Junio,Zambia,0,6,0,6
2012,Junio,Zimbabue,2,7,0,9
2012,Julio,Albania,0,4,0,4
2012,Julio,Alemania,1713,2386,0,4099
2012,Julio,Andorra,0,10,0,10
2012,Julio,Angola,0,1,0,1
2012,Julio,Antigua y Barbuda,2,2,0,4
2012,Julio,Países Bajos,1626,2105,0,3731
2012,Julio,Arabia Saudita,2,3,0,5
2012,Julio,Argelia,1,3,0,4
2012,Julio,Argentina,3741,5295,0,9036
2012,Julio,Aruba,6,8,0,14
2012,Julio,Australia,349,548,0,897
2012,Julio,Austria,197,335,0,532
2012,Julio,Azerbaiyán,7,20,0,27
2012,Julio,Bahamas,7,10,0,17
2012,Julio,Bangladesh,0,1,0,1
2012,Julio,Barbados,7,5,0,12
2012,Julio,República de Belarús,0,3,0,3
2012,Julio,Bélgica,270,471,0,741
2012,Julio,Belice,6,17,0,23
2012,Julio,Bermudas/Territorio Británico de Ultramar,0,3,0,3
2012,Julio,Bolivia,371,501,0,872
2012,Julio,Bosnia y Herzegovina,1,2,0,3
2012,Julio,Brasil,3589,4893,0,8482
2012,Julio,Bulgaria,9,7,0,16
2012,Julio,Burkina Faso,1,0,0,1
2012,Julio,Islas Caimán/Territorio Británico de Ultramar,4,10,0,14
2012,Julio,Camerún,0,1,0,1
2012,Julio,Canadá,1354,2093,0,3447
2012,Julio,España,2608,5260,0,7868
2012,Julio,República Democrática del Congo,2,1,0,3
2012,Julio,República de Corea,132,392,0,524
2012,Julio,Costa Rica,961,1220,0,2181
2012,Julio,Croacia,8,30,0,38
2012,Julio,Cuba,142,282,0,424
2012,Julio,Curazao,7,12,0,19
2012,Julio,República Checa,26,53,0,79
2012,Julio,Chile,2748,3669,0,6417
2012,Julio,China,159,398,0,557
2012,Julio,Chipre,5,1,0,6
2012,Julio,Dinamarca,134,198,0,332
2012,Julio,Dominica,4,3,0,7
2012,Julio,Ecuador,5175,7052,0,12227
2012,Julio,Egipto,6,24,0,30
2012,Julio,El Salvador,435,644,0,1079
2012,Julio,Emiratos Árabes,6,8,0,14
2012,Julio,Eslovaquia,19,8,0,27
2012,Julio,Eslovenia,32,27,0,59
2012,Julio,Estados Unidos de América,12937,20362,0,33299
2012,Julio,Estonia,5,1,0,6
2012,Julio,Etiopia,3,3,0,6
2012,Julio,Filipinas,24,129,0,153
2012,Julio,Finlandia,40,62,0,102
2012,Julio,Francia,1733,2699,0,4432
2012,Julio,Gabón,1,0,0,1
2012,Julio,Georgia,3,6,0,9
2012,Julio,Ghana,1,4,0,5
2012,Julio,Granada,1,1,0,2
2012,Julio,Grecia,27,55,0,82
2012,Julio,Guatemala,246,551,0,797
2012,Julio,Guyana,2,9,0,11
2012,Julio,Guinea Ecuatorial,1,0,0,1
2012,Julio,Guayana Francesa/Departamento de Ultramar Francés,0,1,0,1
2012,Julio,Haití,3,15,0,18
2012,Julio,Honduras,205,411,0,616
2012,Julio,Hungría,25,41,0,66
2012,Julio,India,30,281,0,311
2012,Julio,Indonesia,5,36,0,41
2012,Julio,Irán,7,20,0,27
2012,Julio,República de Irlanda,116,157,0,273
2012,Julio,Islandia,6,10,0,16
2012,Julio,Isla de Man,88,221,0,309
2012,Julio,Isla Johnston,5,0,0,5
2012,Julio,Israel,144,592,0,736
2012,Julio,Islas Aland/Provincia de Finlandia,1,1,0,2
2012,Julio,Italia,634,1740,0,2374
2012,Julio,Jamaica,33,33,0,66
2012,Julio,Islas Marianas del Norte,0,1,0,1
2012,Julio,Japón,175,505,0,680
2012,Julio,Jordania,0,4,0,4
2012,Julio,Kazajistán,1,0,0,1
2012,Julio,Kenia,8,14,0,22
2012,Julio,Kirguistán,1,1,0,2
2012,Julio,Kuwait,1,0,0,1
2012,Julio,Letonia,5,22,0,27
2012,Julio,Lituania,7,12,0,19
2012,Julio,Líbano,27,37,0,64
2012,Julio,Liechtenstein,4,5,0,9
2012,Julio,Luxemburgo,10,9,0,19
2012,Julio,Macedonia,2,2,0,4
2012,Julio,Madagascar,1,0,0,1
2012,Julio,Malasia,7,19,0,26
2012,Julio,Malta,1,2,0,3
2012,Julio,Marruecos,5,13,0,18
2012,Julio,Mauricio,0,1,0,1
2012,Julio,Mauritania,0,1,0,1
2012,Julio,México,2892,5570,0,8462
2012,Julio,República de Moldavia,2,0,0,2
2012,Julio,Montenegro,1,2,0,3
2012,Julio,Mozambique,1,0,0,1
2012,Julio,Myanmar,0,1,0,1
2012,Julio,Namibia,0,2,0,2
2012,Julio,Nepal,0,2,0,2
2012,Julio,Nicaragua,66,87,0,153
2012,Julio,Nigeria,1,4,0,5
2012,Julio,Noruega,128,178,0,306
2012,Julio,Nueva Zelanda,77,128,0,205
2012,Julio,Pakistán,1,17,0,18
2012,Julio,Palau,0,1,0,1
2012,Julio,Panamá,987,1636,0,2623
2012,Julio,Paraguay,72,97,0,169
2012,Julio,Perú,3018,4151,0,7169
2012,Julio,Palestina,2,3,0,5
2012,Julio,Polonia,74,83,0,157
2012,Julio,Portugal,95,299,0,394
2012,Julio,Puerto Rico/Territorio de Estados Unidos,4,6,0,10
2012,Julio,Qatar,0,2,0,2
2012,Julio,Reino Unido de Gran Bretaña e Irlanda del Norte,750,1474,0,2224
2012,Julio,Federación de Rusia,119,152,0,271
2012,Julio,República Dominicana,324,505,0,829
2012,Julio,Rumania,28,51,0,79
2012,Julio,Rwanda,1,0,0,1
2012,Julio,San Cristóbal y Nevis,0,1,0,1
2012,Julio,San Marino,0,1,0,1
2012,Julio,San  Vicente y las Granadinas,0,2,0,2
2012,Julio,Santa Lucia,6,3,0,9
2012,Julio,Santa Sede/Ciudad del Vaticano,0,4,0,4
2012,Julio,Senegal,0,1,0,1
2012,Julio,Serbia,3,6,0,9
2012,Julio,Sierra Leona,0,1,0,1
2012,Julio,Singapur,7,16,0,23
2012,Julio,República Árabe Siria,0,3,0,3
2012,Julio,Sri Lanka,0,3,0,3
2012,Julio,Sudáfrica,15,71,0,86
2012,Julio,Sudán,0,1,0,1
2012,Julio,Suecia,146,214,0,360
2012,Julio,Suiza,757,961,0,1718
2012,Julio,Surinam,18,11,0,29
2012,Julio,Taiwán,35,65,0,100
2012,Julio,Tailandia,9,3,0,12
2012,Julio,Tíbet/Región Autónoma de China,1,1,0,2
2012,Julio,Territorio Antártico Británico/Territorio Británico de Ultramar,2,7,0,9
2012,Julio,Tanzania,0,2,0,2
2012,Julio,Trinidad y Tobago,55,147,0,202
2012,Julio,Túnez,1,2,0,3
2012,Julio,Turkmenistán,0,1,0,1
2012,Julio,Turquía,29,115,0,144
2012,Julio,Ucrania,20,25,0,45
2012,Julio,Uganda,0,3,0,3
2012,Julio,Uruguay,346,491,0,837
2012,Julio,Uzbekistán,2,0,0,2
2012,Julio,Venezuela,9545,11592,0,21137
2012,Julio,Vietnam,1,1,0,2
2012,Julio,Yugoslavia,1,0,0,1
2012,Julio,Zimbabue,0,4,0,4
2012,Julio,Anguila/Territorio Británico de Ultramar,0,3,0,3
2012,Agosto,Albania,1,0,0,1
2012,Agosto,Alemania,1700,2331,0,4031
2012,Agosto,Andorra,1,11,0,12
2012,Agosto,Angola,0,2,0,2
2012,Agosto,Antigua y Barbuda,1,5,0,6
2012,Agosto,Países Bajos,753,1423,0,2176
2012,Agosto,Arabia Saudita,1,3,0,4
2012,Agosto,Argelia,3,4,0,7
2012,Agosto,Argentina,3535,5116,0,8651
2012,Agosto,República de Armenia,0,2,0,2
2012,Agosto,Aruba,3,5,0,8
2012,Agosto,Australia,335,555,0,890
2012,Agosto,Austria,159,272,0,431
2012,Agosto,Azerbaiyán,2,4,0,6
2012,Agosto,Bahamas,5,9,0,14
2012,Agosto,Bangladesh,0,2,0,2
2012,Agosto,Barbados,5,6,0,11
2012,Agosto,República de Belarús,1,3,0,4
2012,Agosto,Bélgica,124,311,0,435
2012,Agosto,Belice,4,10,0,14
2012,Agosto,Benín,1,2,0,3
2012,Agosto,Bermudas/Territorio Británico de Ultramar,0,1,0,1
2012,Agosto,Bolivia,337,482,0,819
2012,Agosto,Bosnia y Herzegovina,1,0,0,1
2012,Agosto,Brasil,2409,4124,0,6533
2012,Agosto,Bulgaria,17,26,0,43
2012,Agosto,Islas Caimán/Territorio Británico de Ultramar,1,0,0,1
2012,Agosto,Camerún,0,4,0,4
2012,Agosto,Canadá,1028,1812,0,2840
2012,Agosto,España,3030,5746,0,8776
2012,Agosto,República Democrática del Congo,2,2,0,4
2012,Agosto,República de Corea,159,325,0,484
2012,Agosto,Costa de Marfil,0,1,0,1
2012,Agosto,Costa Rica,785,1224,0,2009
2012,Agosto,Croacia,8,37,0,45
2012,Agosto,Cuba,116,274,0,390
2012,Agosto,Curazao,4,7,0,11
2012,Agosto,República Checa,33,42,0,75
2012,Agosto,Chile,2537,3819,0,6356
2012,Agosto,China,166,490,0,656
2012,Agosto,Chipre,1,9,0,10
2012,Agosto,Dinamarca,49,130,0,179
2012,Agosto,Dominica,5,5,0,10
2012,Agosto,Ecuador,5724,7539,0,13263
2012,Agosto,Egipto,3,16,0,19
2012,Agosto,El Salvador,492,701,0,1193
2012,Agosto,Emiratos Árabes,0,1,0,1
2012,Agosto,Eritrea,0,2,0,2
2012,Agosto,Eslovaquia,31,15,0,46
2012,Agosto,Eslovenia,8,19,0,27
2012,Agosto,Estados Unidos de América,10494,19522,0,30016
2012,Agosto,Estonia,6,7,0,13
2012,Agosto,Etiopia,0,4,0,4
2012,Agosto,Islas Fiji,1,0,0,1
2012,Agosto,Filipinas,23,165,0,188
2012,Agosto,Finlandia,39,60,0,99
2012,Agosto,Francia,1541,2425,0,3966
2012,Agosto,Gambia,0,1,0,1
2012,Agosto,Georgia,0,1,0,1
2012,Agosto,Ghana,0,2,0,2
2012,Agosto,Granada,3,1,0,4
2012,Agosto,Grecia,21,50,0,71
2012,Agosto,Guatemala,281,613,0,894
2012,Agosto,Guyana,3,17,0,20
2012,Agosto,Guinea Ecuatorial,1,0,0,1
2012,Agosto,Guayana Francesa/Departamento de Ultramar Francés,0,1,0,1
2012,Agosto,Haití,9,19,0,28
2012,Agosto,Honduras,189,280,0,469
2012,Agosto,Hungría,19,37,0,56
2012,Agosto,India,40,305,0,345
2012,Agosto,Indonesia,7,8,0,15
2012,Agosto,Iraq,2,0,0,2
2012,Agosto,Irán,5,20,0,25
2012,Agosto,República de Irlanda,89,153,0,242
2012,Agosto,Islandia,8,13,0,21
2012,Agosto,Isla de Man,69,166,0,235
2012,Agosto,Isla Johnston,0,1,0,1
2012,Agosto,Israel,138,531,0,669
2012,Agosto,Islas Aland/Provincia de Finlandia,0,2,0,2
2012,Agosto,Italia,838,2232,0,3070
2012,Agosto,Jamaica,18,30,0,48
2012,Agosto,Japón,204,536,0,740
2012,Agosto,Jordania,1,3,0,4
2012,Agosto,Kazajistán,0,1,0,1
2012,Agosto,Kenia,7,12,0,19
2012,Agosto,Kuwait,0,3,0,3
2012,Agosto,Letonia,8,9,0,17
2012,Agosto,Lituania,12,13,0,25
2012,Agosto,Líbano,30,49,0,79
2012,Agosto,Liechtenstein,2,3,0,5
2012,Agosto,Luxemburgo,13,24,0,37
2012,Agosto,Madagascar,0,2,0,2
2012,Agosto,Malasia,10,24,0,34
2012,Agosto,Malawi,0,1,0,1
2012,Agosto,Malta,2,2,0,4
2012,Agosto,Marruecos,4,11,0,15
2012,Agosto,Mauricio,1,0,0,1
2012,Agosto,México,2356,5344,0,7700
2012,Agosto,República de Moldavia,3,0,0,3
2012,Agosto,Mónaco,0,1,0,1
2012,Agosto,Mongolia,0,1,0,1
2012,Agosto,Mozambique,1,7,0,8
2012,Agosto,Nepal,0,2,0,2
2012,Agosto,Nicaragua,74,49,0,123
2012,Agosto,Nigeria,1,3,0,4
2012,Agosto,Noruega,56,126,0,182
2012,Agosto,Nueva Zelanda,58,102,0,160
2012,Agosto,Omán,1,0,0,1
2012,Agosto,Papúa Nueva Guinea,0,1,0,1
2012,Agosto,Pakistán,4,15,0,19
2012,Agosto,Panamá,1038,1721,0,2759
2012,Agosto,Paraguay,110,101,0,211
2012,Agosto,Perú,3458,4592,0,8050
2012,Agosto,Palestina,1,4,0,5
2012,Agosto,Polonia,98,134,0,232
2012,Agosto,Portugal,95,310,0,405
2012,Agosto,Puerto Rico/Territorio de Estados Unidos,1,5,0,6
2012,Agosto,Qatar,3,1,0,4
2012,Agosto,Reino Unido de Gran Bretaña e Irlanda del Norte,677,1375,0,2052
2012,Agosto,República CentroÁfricana,0,1,0,1
2012,Agosto,Federación de Rusia,163,209,0,372
2012,Agosto,República Dominicana,332,488,0,820
2012,Agosto,Rumania,28,49,0,77
2012,Agosto,Rwanda,0,1,0,1
2012,Agosto,San Cristóbal y Nevis,1,4,0,5
2012,Agosto,San  Vicente y las Granadinas,0,4,0,4
2012,Agosto,Santa Lucia,8,3,0,11
2012,Agosto,Serbia,3,3,0,6
2012,Agosto,Sierra Leona,0,1,0,1
2012,Agosto,Singapur,16,22,0,38
2012,Agosto,República Árabe Siria,1,2,0,3
2012,Agosto,Sri Lanka,1,3,0,4
2012,Agosto,Sudáfrica,36,113,0,149
2012,Agosto,Sudán,2,0,0,2
2012,Agosto,Suecia,97,203,0,300
2012,Agosto,Suiza,312,556,0,868
2012,Agosto,Surinam,7,12,0,19
2012,Agosto,Taiwán,41,82,0,123
2012,Agosto,Tailandia,9,10,0,19
2012,Agosto,Territorio Antártico Británico/Territorio Británico de Ultramar,0,8,0,8
2012,Agosto,Tanzania,0,1,0,1
2012,Agosto,Togo,0,2,0,2
2012,Agosto,Trinidad y Tobago,97,144,0,241
2012,Agosto,Túnez,2,6,0,8
2012,Agosto,Turkmenistán,1,0,0,1
2012,Agosto,Turquía,47,72,0,119
2012,Agosto,Ucrania,19,21,0,40
2012,Agosto,Uganda,5,1,0,6
2012,Agosto,Uruguay,367,595,0,962
2012,Agosto,Venezuela,15200,14824,0,30024
2012,Agosto,Vietnam,3,3,0,6
2012,Agosto,Yugoslavia,1,0,0,1
2012,Agosto,Zambia,1,0,0,1
2012,Agosto,Zimbabue,4,3,0,7
2012,Agosto,Desconocido,0,1,0,1
2012,Septiembre,Afganistán,0,1,0,1
2012,Septiembre,Albania,2,4,0,6
2012,Septiembre,Alemania,1120,1892,0,3012
2012,Septiembre,Andorra,2,5,0,7
2012,Septiembre,Angola,1,2,0,3
2012,Septiembre,Antigua y Barbuda,0,2,0,2
2012,Septiembre,Países Bajos,789,1386,0,2175
2012,Septiembre,Arabia Saudita,0,2,0,2
2012,Septiembre,Argelia,4,9,0,13
2012,Septiembre,Argentina,3888,5405,0,9293
2012,Septiembre,República de Armenia,2,2,0,4
2012,Septiembre,Aruba,4,2,0,6
2012,Septiembre,Australia,283,526,0,809
2012,Septiembre,Austria,75,237,0,312
2012,Septiembre,Azerbaiyán,1,2,0,3
2012,Septiembre,Bahamas,0,36,0,36
2012,Septiembre,Bangladesh,0,4,0,4
2012,Septiembre,Barbados,1,10,0,11
2012,Septiembre,República de Belarús,2,0,0,2
2012,Septiembre,Bélgica,125,263,0,388
2012,Septiembre,Belice,6,13,0,19
2012,Septiembre,Benín,0,4,0,4
2012,Septiembre,Bermudas/Territorio Británico de Ultramar,1,3,0,4
2012,Septiembre,Bolivia,411,554,0,965
2012,Septiembre,Bosnia y Herzegovina,0,1,0,1
2012,Septiembre,Brasil,2802,4474,0,7276
2012,Septiembre,Bulgaria,7,24,0,31
2012,Septiembre,Burundi,0,1,0,1
2012,Septiembre,Cabo Verde,0,3,0,3
2012,Septiembre,Islas Caimán/Territorio Británico de Ultramar,1,2,0,3
2012,Septiembre,Camerún,2,3,0,5
2012,Septiembre,Canadá,643,1569,0,2212
2012,Septiembre,España,2298,5735,0,8033
2012,Septiembre,República de Corea,104,412,0,516
2012,Septiembre,Costa de Marfil,0,2,0,2
2012,Septiembre,Costa Rica,847,1196,0,2043
2012,Septiembre,Croacia,6,29,0,35
2012,Septiembre,Cuba,113,263,0,376
2012,Septiembre,Curazao,7,12,0,19
2012,Septiembre,República Checa,28,61,0,89
2012,Septiembre,Chile,3150,4283,0,7433
2012,Septiembre,China,187,486,0,673
2012,Septiembre,Chipre,4,2,0,6
2012,Septiembre,Dinamarca,51,135,0,186
2012,Septiembre,Dominica,4,9,0,13
2012,Septiembre,Ecuador,3552,5626,0,9178
2012,Septiembre,Egipto,1,10,0,11
2012,Septiembre,El Salvador,442,836,0,1278
2012,Septiembre,Emiratos Árabes,1,13,0,14
2012,Septiembre,Eslovaquia,16,19,0,35
2012,Septiembre,Eslovenia,8,23,0,31
2012,Septiembre,Estados Unidos de América,6498,15202,0,21700
2012,Septiembre,Estonia,1,7,0,8
2012,Septiembre,Etiopia,3,4,0,7
2012,Septiembre,Filipinas,23,219,0,242
2012,Septiembre,Finlandia,32,70,0,102
2012,Septiembre,Francia,779,1740,0,2519
2012,Septiembre,Georgia,4,0,0,4
2012,Septiembre,Ghana,0,3,0,3
2012,Septiembre,Granada,0,3,0,3
2012,Septiembre,Grecia,15,55,0,70
2012,Septiembre,Guatemala,338,893,0,1231
2012,Septiembre,Guyana,2,18,0,20
2012,Septiembre,Haití,10,18,0,28
2012,Septiembre,Honduras,176,307,0,483
2012,Septiembre,Hungría,24,47,0,71
2012,Septiembre,India,31,312,0,343
2012,Septiembre,Indonesia,7,60,0,67
2012,Septiembre,Irán,3,14,0,17
2012,Septiembre,República de Irlanda,78,127,0,205
2012,Septiembre,Islandia,5,13,0,18
2012,Septiembre,Isla de Man,49,163,0,212
2012,Septiembre,Israel,126,484,0,610
2012,Septiembre,Islas Aland/Provincia de Finlandia,0,1,0,1
2012,Septiembre,Italia,430,1648,0,2078
2012,Septiembre,Islas del Canal,1,1,0,2
2012,Septiembre,Jamaica,12,11,0,23
2012,Septiembre,Japón,164,498,0,662
2012,Septiembre,Jordania,5,6,0,11
2012,Septiembre,Kazajistán,4,3,0,7
2012,Septiembre,Kenia,5,16,0,21
2012,Septiembre,Kuwait,0,1,0,1
2012,Septiembre,Letonia,4,26,0,30
2012,Septiembre,Lituania,3,18,0,21
2012,Septiembre,Líbano,32,49,0,81
2012,Septiembre,Libia,0,2,0,2
2012,Septiembre,Liechtenstein,0,3,0,3
2012,Septiembre,Luxemburgo,3,8,0,11
2012,Septiembre,Macedonia,0,1,0,1
2012,Septiembre,Madagascar,1,0,0,1
2012,Septiembre,Malasia,26,71,0,97
2012,Septiembre,Malta,0,2,0,2
2012,Septiembre,Marruecos,11,7,0,18
2012,Septiembre,Mauricio,0,1,0,1
2012,Septiembre,Mauritania,3,1,0,4
2012,Septiembre,México,2166,5659,0,7825
2012,Septiembre,República de Moldavia,2,0,0,2
2012,Septiembre,Mongolia,1,0,0,1
2012,Septiembre,Mozambique,0,2,0,2
2012,Septiembre,Namibia,1,0,0,1
2012,Septiembre,Nepal,0,1,0,1
2012,Septiembre,Nicaragua,80,148,0,228
2012,Septiembre,Nigeria,2,10,0,12
2012,Septiembre,Noruega,45,122,0,167
2012,Septiembre,Nueva Caledonia/Territorio francés,0,1,0,1
2012,Septiembre,Nueva Zelanda,60,101,0,161
2012,Septiembre,Pakistán,2,9,0,11
2012,Septiembre,Panamá,1080,1616,0,2696
2012,Septiembre,Paraguay,125,189,0,314
2012,Septiembre,Perú,3064,4605,0,7669
2012,Septiembre,Palestina,2,1,0,3
2012,Septiembre,Polonia,63,125,0,188
2012,Septiembre,Portugal,106,386,0,492
2012,Septiembre,Puerto Rico/Territorio de Estados Unidos,0,4,0,4
2012,Septiembre,Qatar,0,1,0,1
2012,Septiembre,Reino Unido de Gran Bretaña e Irlanda del Norte,514,1279,0,1793
2012,Septiembre,República CentroÁfricana,1,2,0,3
2012,Septiembre,Federación de Rusia,145,183,0,328
2012,Septiembre,República Dominicana,324,669,0,993
2012,Septiembre,Rumania,37,71,0,108
2012,Septiembre,San Cristóbal y Nevis,0,5,0,5
2012,Septiembre,Santa Lucia,3,4,0,7
2012,Septiembre,Senegal,1,2,0,3
2012,Septiembre,Serbia,2,6,0,8
2012,Septiembre,Sierra Leona,0,1,0,1
2012,Septiembre,Singapur,17,23,0,40
2012,Septiembre,República Árabe Siria,2,2,0,4
2012,Septiembre,Sri Lanka,1,1,0,2
2012,Septiembre,Sudáfrica,26,71,0,97
2012,Septiembre,Suecia,116,213,0,329
2012,Septiembre,Suiza,223,530,0,753
2012,Septiembre,Surinam,16,17,0,33
2012,Septiembre,Taiwán,71,114,0,185
2012,Septiembre,Tailandia,8,9,0,17
2012,Septiembre,Territorio Antártico Británico/Territorio Británico de Ultramar,1,8,0,9
2012,Septiembre,Tanzania,0,2,0,2
2012,Septiembre,Trinidad y Tobago,98,142,0,240
2012,Septiembre,Túnez,0,2,0,2
2012,Septiembre,Turkmenistán,1,0,0,1
2012,Septiembre,Turquía,13,81,0,94
2012,Septiembre,Ucrania,17,16,0,33
2012,Septiembre,Uganda,0,3,0,3
2012,Septiembre,Uruguay,319,697,0,1016
2012,Septiembre,Uzbekistán,0,1,0,1
2012,Septiembre,Venezuela,10526,11949,0,22475
2012,Septiembre,Zimbabue,0,1,0,1
2012,Octubre,Albania,1,6,0,7
2012,Octubre,Alemania,1085,2044,0,3129
2012,Octubre,Andorra,3,8,0,11
2012,Octubre,Angola,1,2,0,3
2012,Octubre,Antigua y Barbuda,4,2,0,6
2012,Octubre,Países Bajos,903,1493,0,2396
2012,Octubre,Arabia Saudita,0,8,0,8
2012,Octubre,Argelia,1,2,0,3
2012,Octubre,Argentina,3807,5428,0,9235
2012,Octubre,República de Armenia,0,2,0,2
2012,Octubre,Aruba,2,3,0,5
2012,Octubre,Australia,305,570,0,875
2012,Octubre,Austria,102,212,0,314
2012,Octubre,Azerbaiyán,2,1,0,3
2012,Octubre,Bahamas,5,2,0,7
2012,Octubre,Bangladesh,1,5,0,6
2012,Octubre,Barbados,2,5,0,7
2012,Octubre,República de Belarús,9,13,0,22
2012,Octubre,Bélgica,102,355,0,457
2012,Octubre,Belice,5,18,0,23
2012,Octubre,Benín,1,0,0,1
2012,Octubre,Bermudas/Territorio Británico de Ultramar,0,1,0,1
2012,Octubre,Bolivia,341,546,0,887
2012,Octubre,Bosnia y Herzegovina,1,1,0,2
2012,Octubre,Brasil,2587,4458,0,7045
2012,Octubre,Brunei Darussalam,4,2,0,6
2012,Octubre,Bulgaria,7,12,0,19
2012,Octubre,Cabo Verde,1,0,0,1
2012,Octubre,Camboya,2,2,0,4
2012,Octubre,Camerún,0,25,0,25
2012,Octubre,Canadá,694,1689,0,2383
2012,Octubre,España,2387,6103,0,8490
2012,Octubre,República Democrática del Congo,4,2,0,6
2012,Octubre,República de Corea,113,446,0,559
2012,Octubre,Costa de Marfil,3,5,0,8
2012,Octubre,Costa Rica,814,1227,0,2041
2012,Octubre,Croacia,8,35,0,43
2012,Octubre,Cuba,161,258,0,419
2012,Octubre,Curazao,3,2,0,5
2012,Octubre,República Checa,23,54,0,77
2012,Octubre,Chile,2819,4208,0,7027
2012,Octubre,China,215,604,0,819
2012,Octubre,Chipre,2,4,0,6
2012,Octubre,Dinamarca,68,139,0,207
2012,Octubre,Dominica,2,3,0,5
2012,Octubre,Ecuador,3682,6108,0,9790
2012,Octubre,Egipto,6,15,0,21
2012,Octubre,El Salvador,487,784,0,1271
2012,Octubre,Emiratos Árabes,0,1,0,1
2012,Octubre,Eritrea,0,1,0,1
2012,Octubre,Eslovaquia,10,10,0,20
2012,Octubre,Eslovenia,17,22,0,39
2012,Octubre,Estados Unidos de América,6537,15410,0,21947
2012,Octubre,Estonia,8,14,0,22
2012,Octubre,Etiopia,3,2,0,5
2012,Octubre,Filipinas,23,193,0,216
2012,Octubre,Finlandia,51,97,0,148
2012,Octubre,Francia,1044,2033,0,3077
2012,Octubre,Gabón,1,2,0,3
2012,Octubre,Georgia,1,0,0,1
2012,Octubre,Ghana,1,3,0,4
2012,Octubre,Granada,0,1,0,1
2012,Octubre,Grecia,14,69,0,83
2012,Octubre,Guatemala,309,630,0,939
2012,Octubre,Guyana,6,14,0,20
2012,Octubre,Guayana Francesa/Departamento de Ultramar Francés,0,1,0,1
2012,Octubre,Haití,6,76,0,82
2012,Octubre,Honduras,174,320,0,494
2012,Octubre,Hong Kong,0,1,0,1
2012,Octubre,Hungría,13,27,0,40
2012,Octubre,India,37,289,0,326
2012,Octubre,Indonesia,9,27,0,36
2012,Octubre,Iraq,7,5,0,12
2012,Octubre,Irán,6,14,0,20
2012,Octubre,República de Irlanda,59,139,0,198
2012,Octubre,Islandia,6,15,0,21
2012,Octubre,Isla de Man,68,177,0,245
2012,Octubre,Isla Johnston,0,2,0,2
2012,Octubre,Israel,100,524,0,624
2012,Octubre,Islas Aland/Provincia de Finlandia,0,2,0,2
2012,Octubre,Italia,484,1851,0,2335
2012,Octubre,Islas del Canal,0,1,0,1
2012,Octubre,Jamaica,18,39,0,57
2012,Octubre,Japón,101,528,0,629
2012,Octubre,Jordania,1,7,0,8
2012,Octubre,Kazajistán,0,6,0,6
2012,Octubre,Kenia,5,18,0,23
2012,Octubre,Kirguistán,1,1,0,2
2012,Octubre,Letonia,2,12,0,14
2012,Octubre,Lituania,13,15,0,28
2012,Octubre,Líbano,21,44,0,65
2012,Octubre,Libia,0,1,0,1
2012,Octubre,Liechtenstein,0,2,0,2
2012,Octubre,Luxemburgo,3,13,0,16
2012,Octubre,Macedonia,0,1,0,1
2012,Octubre,Madagascar,1,2,0,3
2012,Octubre,Malasia,15,20,0,35
2012,Octubre,Malawi,0,1,0,1
2012,Octubre,Malí,0,1,0,1
2012,Octubre,Malta,2,0,0,2
2012,Octubre,Marruecos,3,7,0,10
2012,Octubre,Mauricio,1,1,0,2
2012,Octubre,México,2364,5540,0,7904
2012,Octubre,República de Moldavia,3,1,0,4
2012,Octubre,Mongolia,2,1,0,3
2012,Octubre,Myanmar,0,1,0,1
2012,Octubre,Namibia,1,4,0,5
2012,Octubre,Nepal,1,1,0,2
2012,Octubre,Nicaragua,106,125,0,231
2012,Octubre,Nigeria,3,8,0,11
2012,Octubre,Noruega,55,134,0,189
2012,Octubre,Nueva Zelanda,67,110,0,177
2012,Octubre,Pakistán,1,13,0,14
2012,Octubre,Panamá,957,1614,0,2571
2012,Octubre,Paraguay,228,351,0,579
2012,Octubre,Perú,3316,4735,0,8051
2012,Octubre,Palestina,2,4,0,6
2012,Octubre,Polonia,84,139,0,223
2012,Octubre,Portugal,116,362,0,478
2012,Octubre,Puerto Rico/Territorio de Estados Unidos,1,5,0,6
2012,Octubre,Reino Unido de Gran Bretaña e Irlanda del Norte,517,1452,0,1969
2012,Octubre,República CentroÁfricana,0,2,0,2
2012,Octubre,Federación de Rusia,152,288,0,440
2012,Octubre,República Dominicana,335,510,0,845
2012,Octubre,Rumania,39,67,0,106
2012,Octubre,Rwanda,0,3,0,3
2012,Octubre,San Cristóbal y Nevis,0,1,0,1
2012,Octubre,Samoa Estadounidense/Territorio no incorporado de Estados Unidos,0,1,0,1
2012,Octubre,San  Vicente y las Granadinas,2,3,0,5
2012,Octubre,Santa Lucia,12,6,0,18
2012,Octubre,Santa Sede/Ciudad del Vaticano,0,1,0,1
2012,Octubre,Senegal,4,4,0,8
2012,Octubre,Serbia,3,7,0,10
2012,Octubre,Singapur,9,15,0,24
2012,Octubre,República Árabe Siria,0,5,0,5
2012,Octubre,Sri Lanka,0,4,0,4
2012,Octubre,Sudáfrica,29,94,0,123
2012,Octubre,Sudán,0,1,0,1
2012,Octubre,Suecia,140,286,0,426
2012,Octubre,Suiza,278,636,0,914
2012,Octubre,Surinam,15,24,0,39
2012,Octubre,Taiwán,36,76,0,112
2012,Octubre,Tailandia,6,8,0,14
2012,Octubre,Territorio Antártico Británico/Territorio Británico de Ultramar,0,1,0,1
2012,Octubre,Tanzania,0,3,0,3
2012,Octubre,Togo,0,2,0,2
2012,Octubre,Trinidad y Tobago,18,122,0,140
2012,Octubre,Túnez,1,1,0,2
2012,Octubre,Turquía,48,94,0,142
2012,Octubre,Ucrania,24,32,0,56
2012,Octubre,Uganda,2,1,0,3
2012,Octubre,Uruguay,276,489,0,765
2012,Octubre,Venezuela,8052,10717,0,18769
2012,Octubre,Vietnam,2,6,0,8
2012,Octubre,República Árabe de Yemen,0,1,0,1
2012,Octubre,Yugoslavia,1,0,0,1
2012,Octubre,Zambia,0,1,0,1
2012,Octubre,Zimbabue,1,0,0,1
2012,Octubre,Desconocido,1,0,0,1
2012,Noviembre,Afganistán,0,2,0,2
2012,Noviembre,Albania,1,2,0,3
2012,Noviembre,Alemania,1382,2398,0,3780
2012,Noviembre,Andorra,0,12,0,12
2012,Noviembre,Angola,1,0,0,1
2012,Noviembre,Antigua y Barbuda,0,4,0,4
2012,Noviembre,Países Bajos,884,1607,0,2491
2012,Noviembre,Arabia Saudita,1,3,0,4
2012,Noviembre,Argelia,0,3,0,3
2012,Noviembre,Argentina,3849,5158,0,9007
2012,Noviembre,República de Armenia,2,1,0,3
2012,Noviembre,Aruba,6,4,0,10
2012,Noviembre,Australia,377,665,0,1042
2012,Noviembre,Austria,132,280,0,412
2012,Noviembre,Azerbaiyán,0,1,0,1
2012,Noviembre,Bahamas,6,14,0,20
2012,Noviembre,Bangladesh,1,1,0,2
2012,Noviembre,Barbados,4,9,0,13
2012,Noviembre,República de Belarús,4,3,0,7
2012,Noviembre,Bélgica,134,336,0,470
2012,Noviembre,Belice,2,8,0,10
2012,Noviembre,Benín,1,0,0,1
2012,Noviembre,Bermudas/Territorio Británico de Ultramar,1,2,0,3
2012,Noviembre,Bolivia,425,639,0,1064
2012,Noviembre,Bosnia y Herzegovina,0,2,0,2
2012,Noviembre,Botsuana,2,0,0,2
2012,Noviembre,Brasil,2384,4020,0,6404
2012,Noviembre,Bulgaria,7,16,0,23
2012,Noviembre,Burundi,0,2,0,2
2012,Noviembre,Islas Caimán/Territorio Británico de Ultramar,1,1,0,2
2012,Noviembre,Camboya,1,3,0,4
2012,Noviembre,Camerún,1,5,0,6
2012,Noviembre,Canadá,1028,2048,0,3076
2012,Noviembre,España,2384,6552,0,8936
2012,Noviembre,República Democrática del Congo,6,1,0,7
2012,Noviembre,República de Corea,161,562,0,723
2012,Noviembre,Costa de Marfil,1,1,0,2
2012,Noviembre,Costa Rica,848,1189,0,2037
2012,Noviembre,Croacia,2,35,0,37
2012,Noviembre,Cuba,126,207,0,333
2012,Noviembre,Curazao,13,11,0,24
2012,Noviembre,República Checa,32,40,0,72
2012,Noviembre,Chile,2340,3619,0,5959
2012,Noviembre,China,182,566,0,748
2012,Noviembre,Chipre,0,3,0,3
2012,Noviembre,Dinamarca,94,156,0,250
2012,Noviembre,Dominica,3,6,0,9
2012,Noviembre,Ecuador,3950,5680,0,9630
2012,Noviembre,Egipto,2,13,0,15
2012,Noviembre,El Salvador,510,810,0,1320
2012,Noviembre,Emiratos Árabes,1,3,0,4
2012,Noviembre,Eslovaquia,21,20,0,41
2012,Noviembre,Eslovenia,19,35,0,54
2012,Noviembre,Estados Unidos de América,7818,16923,0,24741
2012,Noviembre,Estonia,5,17,0,22
2012,Noviembre,Etiopia,2,3,0,5
2012,Noviembre,Islas Fiji,0,1,0,1
2012,Noviembre,Filipinas,16,176,0,192
2012,Noviembre,Finlandia,37,92,0,129
2012,Noviembre,Francia,1043,2112,0,3155
2012,Noviembre,Gabón,0,2,0,2
2012,Noviembre,Georgia,2,5,0,7
2012,Noviembre,Ghana,0,11,0,11
2012,Noviembre,Granada,1,3,0,4
2012,Noviembre,Grecia,31,78,0,109
2012,Noviembre,Guatemala,329,720,0,1049
2012,Noviembre,Guyana,4,17,0,21
2012,Noviembre,Guinea Ecuatorial,0,1,0,1
2012,Noviembre,Guayana Francesa/Departamento de Ultramar Francés,0,1,0,1
2012,Noviembre,Haití,13,31,0,44
2012,Noviembre,Honduras,204,278,0,482
2012,Noviembre,Hungría,20,32,0,52
2012,Noviembre,India,34,284,0,318
2012,Noviembre,Indonesia,4,70,0,74
2012,Noviembre,Iraq,0,1,0,1
2012,Noviembre,Irán,6,7,0,13
2012,Noviembre,República de Irlanda,61,186,0,247
2012,Noviembre,Islandia,8,13,0,21
2012,Noviembre,Isla de Man,75,219,0,294
2012,Noviembre,Isla Johnston,0,2,0,2
2012,Noviembre,Israel,47,381,0,428
2012,Noviembre,Italia,556,2068,0,2624
2012,Noviembre,Islas del Canal,1,4,0,5
2012,Noviembre,Jamaica,17,18,0,35
2012,Noviembre,Islas Midway/Territorio no incorporado de Estados Unidos,0,1,0,1
2012,Noviembre,Japón,146,562,0,708
2012,Noviembre,Jordania,1,7,0,8
2012,Noviembre,Kazajistán,3,1,0,4
2012,Noviembre,Kenia,5,8,0,13
2012,Noviembre,Kirguistán,2,0,0,2
2012,Noviembre,Kuwait,0,2,0,2
2012,Noviembre,República de Kosovo,0,1,0,1
2012,Noviembre,Letonia,8,25,0,33
2012,Noviembre,Lituania,6,8,0,14
2012,Noviembre,Líbano,21,35,0,56
2012,Noviembre,Liberia,3,1,0,4
2012,Noviembre,Libia,0,1,0,1
2012,Noviembre,Liechtenstein,1,2,0,3
2012,Noviembre,Luxemburgo,3,9,0,12
2012,Noviembre,Macedonia,5,1,0,6
2012,Noviembre,Madagascar,6,0,0,6
2012,Noviembre,Malasia,13,20,0,33
2012,Noviembre,Malawi,0,1,0,1
2012,Noviembre,Malí,1,2,0,3
2012,Noviembre,Malta,0,2,0,2
2012,Noviembre,Marruecos,0,5,0,5
2012,Noviembre,Mauricio,0,1,0,1
2012,Noviembre,Mauritania,0,1,0,1
2012,Noviembre,México,2223,5155,0,7378
2012,Noviembre,República de Moldavia,0,1,0,1
2012,Noviembre,Mónaco,0,2,0,2
2012,Noviembre,Montenegro,0,1,0,1
2012,Noviembre,Montserrat/Territorio Británico de Ultramar,1,1,0,2
2012,Noviembre,Mozambique,1,1,0,2
2012,Noviembre,Namibia,2,1,0,3
2012,Noviembre,Nepal,1,3,0,4
2012,Noviembre,Nicaragua,70,101,0,171
2012,Noviembre,Nigeria,3,5,0,8
2012,Noviembre,Níger,0,1,0,1
2012,Noviembre,Noruega,79,145,0,224
2012,Noviembre,Nueva Zelanda,49,94,0,143
2012,Noviembre,Omán,0,1,0,1
2012,Noviembre,Papúa Nueva Guinea,0,1,0,1
2012,Noviembre,Pakistán,3,18,0,21
2012,Noviembre,Panamá,1118,1763,0,2881
2012,Noviembre,Paraguay,180,159,0,339
2012,Noviembre,Perú,3265,4430,0,7695
2012,Noviembre,Palestina,0,1,0,1
2012,Noviembre,Polonia,127,148,0,275
2012,Noviembre,Portugal,96,317,0,413
2012,Noviembre,Polinesia Francesa/Colectividad de Ultramar Francesa,0,1,0,1
2012,Noviembre,Puerto Rico/Territorio de Estados Unidos,4,2,0,6
2012,Noviembre,Qatar,1,2,0,3
2012,Noviembre,Reino Unido de Gran Bretaña e Irlanda del Norte,563,1389,0,1952
2012,Noviembre,República CentroÁfricana,1,3,0,4
2012,Noviembre,Federación de Rusia,155,215,0,370
2012,Noviembre,República Dominicana,436,596,0,1032
2012,Noviembre,Rumania,40,75,0,115
2012,Noviembre,San Cristóbal y Nevis,2,2,0,4
2012,Noviembre,San  Vicente y las Granadinas,0,2,0,2
2012,Noviembre,Santa Lucia,4,5,0,9
2012,Noviembre,Senegal,0,1,0,1
2012,Noviembre,Serbia,2,7,0,9
2012,Noviembre,Singapur,16,24,0,40
2012,Noviembre,República Árabe Siria,0,6,0,6
2012,Noviembre,Sri Lanka,1,2,0,3
2012,Noviembre,Sudáfrica,27,110,0,137
2012,Noviembre,Sudán,3,1,0,4
2012,Noviembre,Suecia,195,309,0,504
2012,Noviembre,Suiza,306,598,0,904
2012,Noviembre,Surinam,25,33,0,58
2012,Noviembre,Taiwán,37,75,0,112
2012,Noviembre,Tailandia,8,5,0,13
2012,Noviembre,Tíbet/Región Autónoma de China,0,1,0,1
2012,Noviembre,Territorio Antártico Británico/Territorio Británico de Ultramar,0,6,0,6
2012,Noviembre,Tanzania,1,1,0,2
2012,Noviembre,Togo,0,1,0,1
2012,Noviembre,Trinidad y Tobago,16,82,0,98
2012,Noviembre,Túnez,1,2,0,3
2012,Noviembre,Turquía,21,67,0,88
2012,Noviembre,Ucrania,17,38,0,55
2012,Noviembre,Uganda,3,1,0,4
2012,Noviembre,Uruguay,273,452,0,725
2012,Noviembre,Venezuela,7997,10855,0,18852
2012,Noviembre,Vietnam,0,5,0,5
2012,Noviembre,República Árabe de Yemen,0,3,0,3
2012,Noviembre,Yugoslavia,2,1,0,3
2012,Noviembre,Zambia,0,1,0,1
2012,Noviembre,Zimbabue,1,6,0,7
2012,Noviembre,Desconocido,1,3,0,4
2012,Diciembre,Afganistán,0,1,0,1
2012,Diciembre,Albania,2,4,0,6
2012,Diciembre,Alemania,1680,2625,0,4305
2012,Diciembre,Andorra,1,8,0,9
2012,Diciembre,Angola,0,1,0,1
2012,Diciembre,Antigua y Barbuda,0,1,0,1
2012,Diciembre,Países Bajos,1048,1923,0,2971
2012,Diciembre,Arabia Saudita,1,14,0,15
2012,Diciembre,Argelia,3,2,0,5
2012,Diciembre,Argentina,3756,4976,0,8732
2012,Diciembre,República de Armenia,3,0,0,3
2012,Diciembre,Aruba,4,4,0,8
2012,Diciembre,Australia,530,865,0,1395
2012,Diciembre,Austria,167,288,0,455
2012,Diciembre,Azerbaiyán,1,2,0,3
2012,Diciembre,Bahamas,4,11,0,15
2012,Diciembre,Bangladesh,0,2,0,2
2012,Diciembre,Barbados,3,4,0,7
2012,Diciembre,República de Belarús,2,1,0,3
2012,Diciembre,Bélgica,185,418,0,603
2012,Diciembre,Belice,6,11,0,17
2012,Diciembre,Bermudas/Territorio Británico de Ultramar,1,7,0,8
2012,Diciembre,Bolivia,460,542,0,1002
2012,Diciembre,Bosnia y Herzegovina,0,2,0,2
2012,Diciembre,Brasil,2800,3527,0,6327
2012,Diciembre,Bulgaria,11,15,0,26
2012,Diciembre,Cabo Verde,1,0,0,1
2012,Diciembre,Islas Caimán/Territorio Británico de Ultramar,14,26,0,40
2012,Diciembre,Camboya,2,0,0,2
2012,Diciembre,Camerún,1,2,0,3
2012,Diciembre,Canadá,1978,3078,0,5056
2012,Diciembre,España,2690,5609,0,8299
2012,Diciembre,República Democrática del Congo,0,1,0,1
2012,Diciembre,República de Corea,193,439,0,632
2012,Diciembre,Costa de Marfil,1,1,0,2
2012,Diciembre,Costa Rica,1253,1431,0,2684
2012,Diciembre,Croacia,12,29,0,41
2012,Diciembre,Cuba,141,245,0,386
2012,Diciembre,Curazao,14,13,0,27
2012,Diciembre,República Checa,41,50,0,91
2012,Diciembre,Chile,2194,3528,0,5722
2012,Diciembre,China,165,385,0,550
2012,Diciembre,Chipre,1,7,0,8
2012,Diciembre,Dinamarca,74,158,0,232
2012,Diciembre,Dominica,5,2,0,7
2012,Diciembre,Ecuador,4169,6083,0,10252
2012,Diciembre,Egipto,8,23,0,31
2012,Diciembre,El Salvador,362,611,0,973
2012,Diciembre,Emiratos Árabes,0,7,0,7
2012,Diciembre,Eritrea,0,1,0,1
2012,Diciembre,Eslovaquia,12,23,0,35
2012,Diciembre,Eslovenia,7,24,0,31
2012,Diciembre,Estados Unidos de América,12853,22429,0,35282
2012,Diciembre,Estonia,6,11,0,17
2012,Diciembre,Etiopia,1,2,0,3
2012,Diciembre,Filipinas,11,163,0,174
2012,Diciembre,Finlandia,67,109,0,176
2012,Diciembre,Francia,1287,2396,0,3683
2012,Diciembre,Gabón,0,1,0,1
2012,Diciembre,Gambia,0,1,0,1
2012,Diciembre,Georgia,0,1,0,1
2012,Diciembre,Ghana,1,6,0,7
2012,Diciembre,Granada,0,1,0,1
2012,Diciembre,Grecia,32,73,0,105
2012,Diciembre,Guatemala,310,538,0,848
2012,Diciembre,Guyana,6,12,0,18
2012,Diciembre,Guinea Bissau,0,2,0,2
2012,Diciembre,Haití,18,26,0,44
2012,Diciembre,Honduras,165,263,0,428
2012,Diciembre,Hungría,21,30,0,51
2012,Diciembre,India,34,279,0,313
2012,Diciembre,Indonesia,11,26,0,37
2012,Diciembre,Irán,13,24,0,37
2012,Diciembre,República de Irlanda,80,159,0,239
2012,Diciembre,Islandia,10,15,0,25
2012,Diciembre,Isla de Man,104,261,0,365
2012,Diciembre,Isla Johnston,1,0,0,1
2012,Diciembre,Israel,79,373,0,452
2012,Diciembre,Islas Aland/Provincia de Finlandia,0,1,0,1
2012,Diciembre,Italia,718,2127,0,2845
2012,Diciembre,Islas del Canal,0,3,0,3
2012,Diciembre,Jamaica,16,42,0,58
2012,Diciembre,Japón,184,396,0,580
2012,Diciembre,Jordania,5,6,0,11
2012,Diciembre,Kazajistán,2,2,0,4
2012,Diciembre,Kenia,2,7,0,9
2012,Diciembre,Kirguistán,0,1,0,1
2012,Diciembre,Kuwait,0,6,0,6
2012,Diciembre,Letonia,10,15,0,25
2012,Diciembre,Lituania,17,12,0,29
2012,Diciembre,Líbano,17,35,0,52
2012,Diciembre,Libia,0,7,0,7
2012,Diciembre,Liechtenstein,4,6,0,10
2012,Diciembre,Luxemburgo,5,13,0,18
2012,Diciembre,Macedonia,1,0,0,1
2012,Diciembre,Madagascar,0,1,0,1
2012,Diciembre,Malasia,11,27,0,38
2012,Diciembre,Malta,1,5,0,6
2012,Diciembre,Marruecos,1,8,0,9
2012,Diciembre,Mauricio,1,2,0,3
2012,Diciembre,Mauritania,0,1,0,1
2012,Diciembre,México,2651,4958,0,7609
2012,Diciembre,República de Moldavia,1,1,0,2
2012,Diciembre,Mónaco,3,0,0,3
2012,Diciembre,Mongolia,1,0,0,1
2012,Diciembre,Montenegro,0,1,0,1
2012,Diciembre,Mozambique,1,4,0,5
2012,Diciembre,Nepal,1,1,0,2
2012,Diciembre,Nicaragua,68,84,0,152
2012,Diciembre,Nigeria,2,10,0,12
2012,Diciembre,Noruega,190,259,0,449
2012,Diciembre,Nueva Zelanda,68,149,0,217
2012,Diciembre,Omán,1,0,0,1
2012,Diciembre,Pakistán,0,14,0,14
2012,Diciembre,Panamá,1324,2095,0,3419
2012,Diciembre,Paraguay,96,95,0,191
2012,Diciembre,Perú,2733,3986,0,6719
2012,Diciembre,Palestina,1,0,0,1
2012,Diciembre,Polonia,98,131,0,229
2012,Diciembre,Portugal,100,328,0,428
2012,Diciembre,Qatar,0,5,0,5
2012,Diciembre,Reino Unido de Gran Bretaña e Irlanda del Norte,780,1806,0,2586
2012,Diciembre,República CentroÁfricana,1,0,0,1
2012,Diciembre,Federación de Rusia,164,262,0,426
2012,Diciembre,República Dominicana,298,556,0,854
2012,Diciembre,Rumania,39,74,0,113
2012,Diciembre,San Marino,0,3,0,3
2012,Diciembre,San  Vicente y las Granadinas,1,1,0,2
2012,Diciembre,Santa Lucia,6,4,0,10
2012,Diciembre,Santa Sede/Ciudad del Vaticano,0,1,0,1
2012,Diciembre,Senegal,0,4,0,4
2012,Diciembre,Serbia,8,12,0,20
2012,Diciembre,Singapur,6,16,0,22
2012,Diciembre,República Árabe Siria,1,2,0,3
2012,Diciembre,Sri Lanka,0,2,0,2
2012,Diciembre,Sudáfrica,35,76,0,111
2012,Diciembre,Suecia,364,583,0,947
2012,Diciembre,Suiza,551,981,0,1532
2012,Diciembre,Surinam,3,2,0,5
2012,Diciembre,Taiwán,54,76,0,130
2012,Diciembre,Tailandia,1,8,0,9
2012,Diciembre,Tíbet/Región Autónoma de China,0,2,0,2
2012,Diciembre,Territorio Antártico Británico/Territorio Británico de Ultramar,2,4,0,6
2012,Diciembre,Tanzania,0,3,0,3
2012,Diciembre,Trinidad y Tobago,54,78,0,132
2012,Diciembre,Túnez,1,3,0,4
2012,Diciembre,Turquía,34,104,0,138
2012,Diciembre,Ucrania,24,35,0,59
2012,Diciembre,Uruguay,208,421,0,629
2012,Diciembre,Venezuela,14518,16682,0,31200
2012,Diciembre,Vietnam,8,8,0,16
2012,Diciembre,Zambia,0,1,0,1
2013,Enero,Albania,1,1,0,2
2013,Enero,Alemania,1512,2321,0,3833
2013,Enero,Andorra,5,9,0,14
2013,Enero,Angola,0,9,0,9
2013,Enero,Antigua y Barbuda,2,1,0,3
2013,Enero,Países Bajos,880,1418,0,2298
2013,Enero,Arabia Saudita,1,12,0,13
2013,Enero,Argelia,0,6,0,6
2013,Enero,Argentina,7199,7403,0,14602
2013,Enero,República de Armenia,1,1,0,2
2013,Enero,Aruba,6,6,0,12
2013,Enero,Australia,413,696,0,1109
2013,Enero,Austria,141,317,0,458
2013,Enero,Azerbaiyán,1,1,0,2
2013,Enero,Bahamas,3,7,0,10
2013,Enero,Bahréin,0,1,0,1
2013,Enero,Bangladesh,2,5,0,7
2013,Enero,Barbados,7,2,0,9
2013,Enero,República de Belarús,5,8,0,13
2013,Enero,Bélgica,144,384,0,528
2013,Enero,Belice,3,8,0,11
2013,Enero,Benín,0,1,0,1
2013,Enero,Bolivia,519,637,0,1156
2013,Enero,Bosnia y Herzegovina,1,2,0,3
2013,Enero,Brasil,3325,4440,0,7765
2013,Enero,Bulgaria,15,14,0,29
2013,Enero,Burkina Faso,1,1,0,2
2013,Enero,Islas Caimán/Territorio Británico de Ultramar,4,17,0,21
2013,Enero,Camerún,0,6,0,6
2013,Enero,Canadá,2088,2940,0,5028
2013,Enero,España,2448,5751,0,8199
2013,Enero,República Democrática del Congo,0,2,0,2
2013,Enero,República de Corea,210,455,0,665
2013,Enero,Costa de Marfil,1,0,0,1
2013,Enero,Costa Rica,1090,1297,0,2387
2013,Enero,Croacia,7,40,0,47
2013,Enero,Cuba,157,255,0,412
2013,Enero,Curazao,4,2,0,6
2013,Enero,República Checa,53,92,0,145
2013,Enero,Chile,2988,3984,0,6972
2013,Enero,China,147,392,0,539
2013,Enero,Chipre,1,4,0,5
2013,Enero,Dinamarca,81,156,0,237
2013,Enero,Dominica,4,5,0,9
2013,Enero,Ecuador,3192,5194,0,8386
2013,Enero,Egipto,6,22,0,28
2013,Enero,El Salvador,474,699,0,1173
2013,Enero,Emiratos Árabes,0,9,0,9
2013,Enero,Eslovaquia,29,52,0,81
2013,Enero,Eslovenia,24,35,0,59
2013,Enero,Estados Unidos de América,7108,14701,0,21809
2013,Enero,Estonia,15,18,0,33
2013,Enero,Etiopia,2,1,0,3
2013,Enero,Filipinas,23,101,0,124
2013,Enero,Finlandia,68,98,0,166
2013,Enero,Francia,1379,2306,0,3685
2013,Enero,Gabón,1,1,0,2
2013,Enero,Georgia,2,0,0,2
2013,Enero,Ghana,0,3,0,3
2013,Enero,Grecia,9,63,0,72
2013,Enero,Guatemala,251,534,0,785
2013,Enero,Guyana,7,18,0,25
2013,Enero,Guinea Bissau,0,1,0,1
2013,Enero,Guayana Francesa/Departamento de Ultramar Francés,0,1,0,1
2013,Enero,Haití,3,20,0,23
2013,Enero,Honduras,164,223,0,387
2013,Enero,Hong Kong,0,2,0,2
2013,Enero,Hungría,19,44,0,63
2013,Enero,India,47,267,0,314
2013,Enero,Indonesia,5,23,0,28
2013,Enero,Irán,4,8,0,12
2013,Enero,República de Irlanda,62,149,0,211
2013,Enero,Islandia,2,7,0,9
2013,Enero,Isla de Man,78,203,0,281
2013,Enero,Isla Johnston,0,1,0,1
2013,Enero,Israel,97,444,0,541
2013,Enero,Islas Aland/Provincia de Finlandia,2,0,0,2
2013,Enero,Italia,702,2390,0,3092
2013,Enero,Jamaica,16,27,0,43
2013,Enero,Islas Marianas del Norte,0,1,0,1
2013,Enero,Japón,140,492,0,632
2013,Enero,Jordania,0,2,0,2
2013,Enero,Kenia,3,4,0,7
2013,Enero,Kirguistán,3,1,0,4
2013,Enero,Kuwait,0,1,0,1
2013,Enero,Letonia,11,30,0,41
2013,Enero,Lituania,17,16,0,33
2013,Enero,Líbano,21,39,0,60
2013,Enero,Liechtenstein,1,0,0,1
2013,Enero,Luxemburgo,8,13,0,21
2013,Enero,Macedonia,0,2,0,2
2013,Enero,Malasia,10,12,0,22
2013,Enero,Malawi,0,1,0,1
2013,Enero,Malta,0,1,0,1
2013,Enero,Marruecos,1,15,0,16
2013,Enero,Mauricio,0,1,0,1
2013,Enero,México,2027,4300,0,6327
2013,Enero,República de Moldavia,2,0,0,2
2013,Enero,Mónaco,0,2,0,2
2013,Enero,Mongolia,2,0,0,2
2013,Enero,Montenegro,2,0,0,2
2013,Enero,Mozambique,0,4,0,4
2013,Enero,Myanmar,0,2,0,2
2013,Enero,Nepal,0,3,0,3
2013,Enero,Nicaragua,89,79,0,168
2013,Enero,Nigeria,3,12,0,15
2013,Enero,Noruega,102,202,0,304
2013,Enero,Nueva Zelanda,55,89,0,144
2013,Enero,Pakistán,1,14,0,15
2013,Enero,Panamá,1077,1632,0,2709
2013,Enero,Paraguay,118,134,0,252
2013,Enero,Perú,2878,4201,0,7079
2013,Enero,Polonia,98,160,0,258
2013,Enero,Portugal,133,475,0,608
2013,Enero,Puerto Rico/Territorio de Estados Unidos,1,4,0,5
2013,Enero,Qatar,2,22,0,24
2013,Enero,Reino Unido de Gran Bretaña e Irlanda del Norte,656,1467,0,2123
2013,Enero,Federación de Rusia,350,431,0,781
2013,Enero,República Dominicana,291,440,0,731
2013,Enero,Rumania,37,57,0,94
2013,Enero,Rwanda,0,1,0,1
2013,Enero,Samoa Occidental,1,0,0,1
2013,Enero,San  Vicente y las Granadinas,0,2,0,2
2013,Enero,Santa Lucia,10,4,0,14
2013,Enero,Santa Sede/Ciudad del Vaticano,0,1,0,1
2013,Enero,Senegal,0,1,0,1
2013,Enero,Serbia,5,5,0,10
2013,Enero,Sierra Leona,0,2,0,2
2013,Enero,Singapur,16,26,0,42
2013,Enero,República Árabe Siria,2,2,0,4
2013,Enero,Sri Lanka,0,9,0,9
2013,Enero,Sudáfrica,41,77,0,118
2013,Enero,Suecia,229,410,0,639
2013,Enero,Suiza,432,738,0,1170
2013,Enero,Surinam,12,19,0,31
2013,Enero,Taiwán,38,73,0,111
2013,Enero,Tailandia,1,5,0,6
2013,Enero,Tíbet/Región Autónoma de China,0,1,0,1
2013,Enero,Territorio Antártico Británico/Territorio Británico de Ultramar,4,2,0,6
2013,Enero,Tanzania,1,3,0,4
2013,Enero,Togo,0,3,0,3
2013,Enero,Trinidad y Tobago,28,72,0,100
2013,Enero,Túnez,3,1,0,4
2013,Enero,Turkmenistán,2,0,0,2
2013,Enero,Turquía,62,146,0,208
2013,Enero,Ucrania,38,45,0,83
2013,Enero,Uganda,0,2,0,2
2013,Enero,Uruguay,313,418,0,731
2013,Enero,Uzbekistán,1,0,0,1
2013,Enero,Venezuela,9778,11645,0,21423
2013,Enero,Vietnam,1,1,0,2
2013,Enero,Yugoslavia,1,0,0,1
2013,Enero,Zambia,0,1,0,1
2013,Enero,Zimbabue,0,2,0,2
2013,Enero,Desconocido,1,0,0,1
2013,Febrero,Afganistán,0,1,0,1
2013,Febrero,Albania,3,0,0,3
2013,Febrero,Alemania,1513,2454,0,3967
2013,Febrero,Andorra,1,11,0,12
2013,Febrero,Angola,0,2,0,2
2013,Febrero,Antigua y Barbuda,0,3,0,3
2013,Febrero,Países Bajos,930,1517,0,2447
2013,Febrero,Arabia Saudita,0,4,0,4
2013,Febrero,Argelia,1,2,0,3
2013,Febrero,Argentina,5280,6493,0,11773
2013,Febrero,República de Armenia,2,1,0,3
2013,Febrero,Aruba,10,8,0,18
2013,Febrero,Australia,293,594,0,887
2013,Febrero,Austria,127,278,0,405
2013,Febrero,Azerbaiyán,0,3,0,3
2013,Febrero,Bahamas,5,13,0,18
2013,Febrero,Bangladesh,0,20,0,20
2013,Febrero,Barbados,2,3,0,5
2013,Febrero,República de Belarús,5,1,0,6
2013,Febrero,Bélgica,164,342,0,506
2013,Febrero,Belice,5,12,0,17
2013,Febrero,Benín,1,0,0,1
2013,Febrero,Bermudas/Territorio Británico de Ultramar,2,1,0,3
2013,Febrero,Bolivia,1068,862,0,1930
2013,Febrero,Bosnia y Herzegovina,1,1,0,2
2013,Febrero,Brasil,2793,3759,0,6552
2013,Febrero,Bulgaria,13,7,0,20
2013,Febrero,Burundi,0,1,0,1
2013,Febrero,Islas Caimán/Territorio Británico de Ultramar,2,2,0,4
2013,Febrero,Camerún,3,3,0,6
2013,Febrero,Canadá,2055,2881,0,4936
2013,Febrero,España,2041,5360,0,7401
2013,Febrero,República Democrática del Congo,1,2,0,3
2013,Febrero,República de Corea,126,419,0,545
2013,Febrero,Costa de Marfil,0,3,0,3
2013,Febrero,Costa Rica,956,1159,0,2115
2013,Febrero,Croacia,19,27,0,46
2013,Febrero,Cuba,128,237,0,365
2013,Febrero,Curazao,14,13,0,27
2013,Febrero,República Checa,47,83,0,130
2013,Febrero,Chile,4852,5336,0,10188
2013,Febrero,China,178,412,0,590
2013,Febrero,Chipre,0,5,0,5
2013,Febrero,Dinamarca,104,175,0,279
2013,Febrero,Dominica,4,2,0,6
2013,Febrero,Ecuador,4552,5534,0,10086
2013,Febrero,Egipto,1,15,0,16
2013,Febrero,El Salvador,626,857,0,1483
2013,Febrero,Emiratos Árabes,1,7,0,8
2013,Febrero,Eslovaquia,11,33,0,44
2013,Febrero,Eslovenia,27,37,0,64
2013,Febrero,Estados Unidos de América,8222,17433,0,25655
2013,Febrero,Estonia,19,15,0,34
2013,Febrero,Etiopia,2,6,0,8
2013,Febrero,Islas Fiji,0,2,0,2
2013,Febrero,Filipinas,23,98,0,121
2013,Febrero,Finlandia,52,105,0,157
2013,Febrero,Francia,1158,2130,0,3288
2013,Febrero,Gabón,2,2,0,4
2013,Febrero,Gambia,0,2,0,2
2013,Febrero,Georgia,7,2,0,9
2013,Febrero,Ghana,1,5,0,6
2013,Febrero,Granada,1,0,0,1
2013,Febrero,Grecia,30,73,0,103
2013,Febrero,Guatemala,353,728,0,1081
2013,Febrero,Guyana,10,5,0,15
2013,Febrero,Guinea Ecuatorial,0,1,0,1
2013,Febrero,Haití,17,18,0,35
2013,Febrero,Honduras,228,288,0,516
2013,Febrero,Hungría,29,49,0,78
2013,Febrero,India,43,293,0,336
2013,Febrero,Indonesia,11,22,0,33
2013,Febrero,Irán,3,10,0,13
2013,Febrero,República de Irlanda,54,131,0,185
2013,Febrero,Islandia,3,4,0,7
2013,Febrero,Isla de Man,79,172,0,251
2013,Febrero,Israel,88,485,0,573
2013,Febrero,Islas Aland/Provincia de Finlandia,1,0,0,1
2013,Febrero,Italia,600,2037,0,2637
2013,Febrero,Jamaica,20,29,0,49
2013,Febrero,Islas Salomón,1,0,0,1
2013,Febrero,Japón,185,498,0,683
2013,Febrero,Jordania,4,7,0,11
2013,Febrero,Kazajistán,4,3,0,7
2013,Febrero,Kenia,4,10,0,14
2013,Febrero,Kirguistán,1,0,0,1
2013,Febrero,Kuwait,0,6,0,6
2013,Febrero,República de Kosovo,0,1,0,1
2013,Febrero,Letonia,9,17,0,26
2013,Febrero,Lituania,11,32,0,43
2013,Febrero,Líbano,18,25,0,43
2013,Febrero,Liberia,2,1,0,3
2013,Febrero,Libia,0,2,0,2
2013,Febrero,Liechtenstein,2,0,0,2
2013,Febrero,Luxemburgo,9,9,0,18
2013,Febrero,Macedonia,0,1,0,1
2013,Febrero,Madagascar,1,0,0,1
2013,Febrero,Malasia,16,21,0,37
2013,Febrero,Malawi,1,0,0,1
2013,Febrero,Malta,4,4,0,8
2013,Febrero,Marruecos,4,6,0,10
2013,Febrero,Mauricio,0,2,0,2
2013,Febrero,Mauritania,3,1,0,4
2013,Febrero,México,1578,4430,0,6008
2013,Febrero,República de Moldavia,1,4,0,5
2013,Febrero,Mongolia,1,0,0,1
2013,Febrero,Mozambique,0,1,0,1
2013,Febrero,Nepal,0,4,0,4
2013,Febrero,Nicaragua,68,79,0,147
2013,Febrero,Nigeria,3,16,0,19
2013,Febrero,Níger,0,1,0,1
2013,Febrero,Noruega,80,152,0,232
2013,Febrero,Nueva Zelanda,41,83,0,124
2013,Febrero,Omán,0,2,0,2
2013,Febrero,Pakistán,1,22,0,23
2013,Febrero,Panamá,1178,1638,0,2816
2013,Febrero,Paraguay,204,219,0,423
2013,Febrero,Perú,5600,5514,0,11114
2013,Febrero,Palestina,2,1,0,3
2013,Febrero,Polonia,113,161,0,274
2013,Febrero,Portugal,125,337,0,462
2013,Febrero,Puerto Rico/Territorio de Estados Unidos,0,1,0,1
2013,Febrero,Qatar,1,78,0,79
2013,Febrero,Reino Unido de Gran Bretaña e Irlanda del Norte,664,1439,0,2103
2013,Febrero,República CentroÁfricana,0,3,0,3
2013,Febrero,Federación de Rusia,188,266,0,454
2013,Febrero,República Dominicana,365,557,0,922
2013,Febrero,República Democrática Popular de Corea,1,0,0,1
2013,Febrero,Rumania,43,75,0,118
2013,Febrero,San Cristóbal y Nevis,0,3,0,3
2013,Febrero,San  Vicente y las Granadinas,1,2,0,3
2013,Febrero,Santa Lucia,1,2,0,3
2013,Febrero,Senegal,0,1,0,1
2013,Febrero,Serbia,9,16,0,25
2013,Febrero,Singapur,9,14,0,23
2013,Febrero,República Árabe Siria,1,2,0,3
2013,Febrero,Sri Lanka,0,5,0,5
2013,Febrero,Sudáfrica,23,71,0,94
2013,Febrero,Sudán,1,4,0,5
2013,Febrero,Suecia,249,371,0,620
2013,Febrero,Suiza,417,753,0,1170
2013,Febrero,Surinam,11,22,0,33
2013,Febrero,Suazilandia,1,0,0,1
2013,Febrero,Taiwán,39,51,0,90
2013,Febrero,República de Tayikistán,0,1,0,1
2013,Febrero,Tailandia,16,14,0,30
2013,Febrero,Tíbet/Región Autónoma de China,1,4,0,5
2013,Febrero,Territorio Antártico Británico/Territorio Británico de Ultramar,5,4,0,9
2013,Febrero,Tanzania,1,4,0,5
2013,Febrero,Togo,0,2,0,2
2013,Febrero,Trinidad y Tobago,24,52,0,76
2013,Febrero,Túnez,0,4,0,4
2013,Febrero,Turquía,23,71,0,94
2013,Febrero,Ucrania,20,20,0,40
2013,Febrero,Uganda,2,2,0,4
2013,Febrero,Uruguay,379,515,0,894
2013,Febrero,Venezuela,11282,12646,0,23928
2013,Febrero,Vietnam,1,0,0,1
2013,Febrero,República Árabe de Yemen,0,1,0,1
2013,Febrero,Zambia,0,2,0,2
2013,Febrero,Zimbabue,0,1,0,1
2013,Febrero,Desconocido,31,69,0,100
2013,Marzo,Albania,2,2,0,4
2013,Marzo,Alemania,1679,2570,0,4249
2013,Marzo,Andorra,2,9,0,11
2013,Marzo,Angola,0,1,0,1
2013,Marzo,Antigua y Barbuda,0,2,0,2
2013,Marzo,Países Bajos,925,1527,0,2452
2013,Marzo,Arabia Saudita,1,15,0,16
2013,Marzo,Argelia,2,3,0,5
2013,Marzo,Argentina,5615,6530,0,12145
2013,Marzo,República de Armenia,0,1,0,1
2013,Marzo,Aruba,2,0,0,2
2013,Marzo,Australia,299,554,0,853
2013,Marzo,Austria,126,277,0,403
2013,Marzo,Azerbaiyán,1,0,0,1
2013,Marzo,Bahamas,3,5,0,8
2013,Marzo,Bangladesh,1,3,0,4
2013,Marzo,Barbados,6,10,0,16
2013,Marzo,República de Belarús,1,6,0,7
2013,Marzo,Bélgica,139,321,0,460
2013,Marzo,Belice,4,14,0,18
2013,Marzo,Bermudas/Territorio Británico de Ultramar,3,1,0,4
2013,Marzo,Bolivia,288,533,0,821
2013,Marzo,Bosnia y Herzegovina,1,1,0,2
2013,Marzo,Brasil,2158,3538,0,5696
2013,Marzo,Bulgaria,8,9,0,17
2013,Marzo,Bután,0,1,0,1
2013,Marzo,Islas Caimán/Territorio Británico de Ultramar,1,18,0,19
2013,Marzo,Camboya,0,1,0,1
2013,Marzo,Camerún,0,1,0,1
2013,Marzo,Canadá,1835,2552,0,4387
2013,Marzo,España,2332,5362,0,7694
2013,Marzo,República Democrática del Congo,0,1,0,1
2013,Marzo,República de Corea,155,524,0,679
2013,Marzo,Costa Rica,920,1272,0,2192
2013,Marzo,Croacia,8,32,0,40
2013,Marzo,Cuba,121,199,0,320
2013,Marzo,Curazao,10,12,0,22
2013,Marzo,República Checa,40,45,0,85
2013,Marzo,Chile,2519,3732,0,6251
2013,Marzo,China,186,545,0,731
2013,Marzo,Chipre,1,2,0,3
2013,Marzo,Dinamarca,85,181,0,266
2013,Marzo,Dominica,1,2,0,3
2013,Marzo,Ecuador,3456,5041,0,8497
2013,Marzo,Egipto,1,32,0,33
2013,Marzo,El Salvador,490,787,0,1277
2013,Marzo,Emiratos Árabes,1,0,0,1
2013,Marzo,Eslovaquia,20,37,0,57
2013,Marzo,Eslovenia,12,38,0,50
2013,Marzo,Estados Unidos de América,9525,17368,0,26893
2013,Marzo,Estonia,14,13,0,27
2013,Marzo,Etiopia,2,3,0,5
2013,Marzo,Islas Fiji,2,2,0,4
2013,Marzo,Filipinas,31,164,0,195
2013,Marzo,Finlandia,47,75,0,122
2013,Marzo,Francia,1104,2079,0,3183
2013,Marzo,Gabón,1,1,0,2
2013,Marzo,Georgia,5,3,0,8
2013,Marzo,Ghana,2,4,0,6
2013,Marzo,Grecia,27,67,0,94
2013,Marzo,Guatemala,268,627,0,895
2013,Marzo,Guyana,10,22,0,32
2013,Marzo,Guinea,0,1,0,1
2013,Marzo,Guayana Francesa/Departamento de Ultramar Francés,0,1,0,1
2013,Marzo,Haití,5,16,0,21
2013,Marzo,Honduras,180,239,0,419
2013,Marzo,Hungría,46,92,0,138
2013,Marzo,India,40,298,0,338
2013,Marzo,Indonesia,10,19,0,29
2013,Marzo,Iraq,0,2,0,2
2013,Marzo,Irán,4,37,0,41
2013,Marzo,República de Irlanda,64,150,0,214
2013,Marzo,Islandia,1,0,0,1
2013,Marzo,Isla de Man,78,201,0,279
2013,Marzo,Isla Johnston,0,2,0,2
2013,Marzo,Israel,95,482,0,577
2013,Marzo,Islas Aland/Provincia de Finlandia,1,4,0,5
2013,Marzo,Italia,515,1676,0,2191
2013,Marzo,Jamaica,23,41,0,64
2013,Marzo,Islas Salomón,1,0,0,1
2013,Marzo,Japón,176,536,0,712
2013,Marzo,Jordania,1,2,0,3
2013,Marzo,Kazajistán,2,8,0,10
2013,Marzo,Kenia,4,7,0,11
2013,Marzo,Lesoto,0,2,0,2
2013,Marzo,Letonia,4,8,0,12
2013,Marzo,Lituania,20,17,0,37
2013,Marzo,Líbano,13,34,0,47
2013,Marzo,Liechtenstein,0,1,0,1
2013,Marzo,Luxemburgo,11,17,0,28
2013,Marzo,Macedonia,0,1,0,1
2013,Marzo,Malasia,15,28,0,43
2013,Marzo,Malí,1,2,0,3
2013,Marzo,Malta,1,6,0,7
2013,Marzo,Marruecos,4,9,0,13
2013,Marzo,Mauricio,0,1,0,1
2013,Marzo,México,2152,4729,0,6881
2013,Marzo,República de Moldavia,1,0,0,1
2013,Marzo,Mónaco,0,1,0,1
2013,Marzo,Mongolia,2,8,0,10
2013,Marzo,Montenegro,0,1,0,1
2013,Marzo,Myanmar,1,1,0,2
2013,Marzo,Namibia,0,1,0,1
2013,Marzo,Nepal,1,1,0,2
2013,Marzo,Nicaragua,61,74,0,135
2013,Marzo,Nigeria,5,9,0,14
2013,Marzo,Noruega,130,178,0,308
2013,Marzo,Nueva Zelanda,67,129,0,196
2013,Marzo,Pakistán,3,12,0,15
2013,Marzo,Panamá,862,1461,0,2323
2013,Marzo,Paraguay,86,123,0,209
2013,Marzo,Perú,3155,4350,0,7505
2013,Marzo,Palestina,2,3,0,5
2013,Marzo,Polonia,86,124,0,210
2013,Marzo,Portugal,152,393,0,545
2013,Marzo,Puerto Rico/Territorio de Estados Unidos,5,1,0,6
2013,Marzo,Reino Unido de Gran Bretaña e Irlanda del Norte,682,1571,0,2253
2013,Marzo,Federación de Rusia,154,214,0,368
2013,Marzo,República Dominicana,300,508,0,808
2013,Marzo,Rumania,37,73,0,110
2013,Marzo,San Cristóbal y Nevis,0,2,0,2
2013,Marzo,San Marino,1,3,0,4
2013,Marzo,San  Vicente y las Granadinas,2,2,0,4
2013,Marzo,Santa Lucia,4,2,0,6
2013,Marzo,Santa Sede/Ciudad del Vaticano,0,1,0,1
2013,Marzo,Senegal,0,1,0,1
2013,Marzo,Serbia,7,9,0,16
2013,Marzo,Singapur,12,14,0,26
2013,Marzo,República Árabe Siria,0,2,0,2
2013,Marzo,Sri Lanka,2,1,0,3
2013,Marzo,Sudáfrica,49,86,0,135
2013,Marzo,Suecia,165,283,0,448
2013,Marzo,Suiza,393,650,0,1043
2013,Marzo,Surinam,6,25,0,31
2013,Marzo,Taiwán,91,136,0,227
2013,Marzo,Tailandia,4,4,0,8
2013,Marzo,Tíbet/Región Autónoma de China,0,2,0,2
2013,Marzo,Territorio Antártico Británico/Territorio Británico de Ultramar,5,3,0,8
2013,Marzo,Tanzania,1,1,0,2
2013,Marzo,Trinidad y Tobago,23,65,0,88
2013,Marzo,Túnez,1,2,0,3
2013,Marzo,Turquía,21,68,0,89
2013,Marzo,Ucrania,19,23,0,42
2013,Marzo,Uganda,0,3,0,3
2013,Marzo,Uruguay,300,489,0,789
2013,Marzo,Uzbekistán,1,0,0,1
2013,Marzo,Venezuela,9081,10847,0,19928
2013,Marzo,Vietnam,2,6,0,8
2013,Marzo,Zambia,0,1,0,1
2013,Marzo,Zimbabue,2,4,0,6
2013,Marzo,Desconocido,0,2,0,2
2013,Abril,Albania,6,2,0,8
2013,Abril,Alemania,1127,1941,0,3068
2013,Abril,Andorra,2,12,0,14
2013,Abril,Antigua y Barbuda,0,1,0,1
2013,Abril,Países Bajos,986,1647,0,2633
2013,Abril,Arabia Saudita,0,6,0,6
2013,Abril,Argelia,1,3,0,4
2013,Abril,Argentina,4915,6126,0,11041
2013,Abril,República de Armenia,0,1,0,1
2013,Abril,Aruba,4,11,0,15
2013,Abril,Australia,264,514,0,778
2013,Abril,Austria,76,209,0,285
2013,Abril,Azerbaiyán,3,3,0,6
2013,Abril,Bahamas,3,12,0,15
2013,Abril,Bangladesh,2,4,0,6
2013,Abril,Barbados,3,8,0,11
2013,Abril,República de Belarús,7,4,0,11
2013,Abril,Bélgica,106,353,0,459
2013,Abril,Belice,2,16,0,18
2013,Abril,Bermudas/Territorio Británico de Ultramar,0,3,0,3
2013,Abril,Bolivia,357,561,0,918
2013,Abril,Botsuana,0,3,0,3
2013,Abril,Brasil,2327,4191,0,6518
2013,Abril,Bulgaria,19,12,0,31
2013,Abril,Bután,0,1,0,1
2013,Abril,Islas Caimán/Territorio Británico de Ultramar,6,7,0,13
2013,Abril,Camerún,2,3,0,5
2013,Abril,Canadá,806,1642,0,2448
2013,Abril,Chad,0,2,0,2
2013,Abril,España,1976,5648,0,7624
2013,Abril,República Democrática del Congo,0,4,0,4
2013,Abril,República de Corea,122,387,0,509
2013,Abril,Costa de Marfil,0,1,0,1
2013,Abril,Costa Rica,912,1324,0,2236
2013,Abril,Croacia,4,27,0,31
2013,Abril,Cuba,104,226,0,330
2013,Abril,Curazao,6,10,0,16
2013,Abril,República Checa,29,46,0,75
2013,Abril,Chile,2704,4067,0,6771
2013,Abril,China,207,665,0,872
2013,Abril,Chipre,0,6,0,6
2013,Abril,Dinamarca,65,127,0,192
2013,Abril,Dominica,0,10,0,10
2013,Abril,Ecuador,4201,5968,0,10169
2013,Abril,Egipto,4,26,0,30
2013,Abril,El Salvador,624,885,0,1509
2013,Abril,Emiratos Árabes,0,4,0,4
2013,Abril,Eslovaquia,14,16,0,30
2013,Abril,Eslovenia,14,36,0,50
2013,Abril,Estados Unidos de América,7376,16213,0,23589
2013,Abril,Estonia,3,6,0,9
2013,Abril,Etiopia,2,5,0,7
2013,Abril,Filipinas,25,103,0,128
2013,Abril,Finlandia,41,102,0,143
2013,Abril,Francia,925,1875,0,2800
2013,Abril,Gabón,0,2,0,2
2013,Abril,Gambia,1,0,0,1
2013,Abril,Georgia,2,1,0,3
2013,Abril,Ghana,1,1,0,2
2013,Abril,Granada,1,0,0,1
2013,Abril,Grecia,18,61,0,79
2013,Abril,Guatemala,255,657,0,912
2013,Abril,Guyana,3,20,0,23
2013,Abril,Guinea Ecuatorial,1,0,0,1
2013,Abril,Haití,6,14,0,20
2013,Abril,Honduras,167,287,0,454
2013,Abril,Hungría,20,42,0,62
2013,Abril,India,38,300,0,338
2013,Abril,Indonesia,16,23,0,39
2013,Abril,Iraq,0,18,0,18
2013,Abril,Irán,1,10,0,11
2013,Abril,República de Irlanda,90,132,0,222
2013,Abril,Islandia,6,10,0,16
2013,Abril,Isla de Man,110,186,0,296
2013,Abril,Israel,152,750,0,902
2013,Abril,Italia,442,1807,0,2249
2013,Abril,Islas del Canal,1,0,0,1
2013,Abril,Jamaica,13,29,0,42
2013,Abril,Japón,124,525,0,649
2013,Abril,Jordania,3,3,0,6
2013,Abril,Kenia,2,6,0,8
2013,Abril,Kuwait,0,1,0,1
2013,Abril,Lesoto,1,2,0,3
2013,Abril,Letonia,12,15,0,27
2013,Abril,Lituania,18,14,0,32
2013,Abril,Líbano,17,32,0,49
2013,Abril,Liberia,0,1,0,1
2013,Abril,Libia,1,0,0,1
2013,Abril,Luxemburgo,5,15,0,20
2013,Abril,Macedonia,1,2,0,3
2013,Abril,Madagascar,2,1,0,3
2013,Abril,Malasia,10,35,0,45
2013,Abril,Malta,1,5,0,6
2013,Abril,Marruecos,2,16,0,18
2013,Abril,Mauricio,0,1,0,1
2013,Abril,Mauritania,0,1,0,1
2013,Abril,México,1909,4847,0,6756
2013,Abril,República de Moldavia,1,1,0,2
2013,Abril,Montenegro,1,1,0,2
2013,Abril,Mozambique,2,4,0,6
2013,Abril,Myanmar,0,2,0,2
2013,Abril,Namibia,1,1,0,2
2013,Abril,Nepal,0,1,0,1
2013,Abril,Nicaragua,53,85,0,138
2013,Abril,Nigeria,2,11,0,13
2013,Abril,Noruega,78,147,0,225
2013,Abril,Nueva Zelanda,63,82,0,145
2013,Abril,Pakistán,1,7,0,8
2013,Abril,Palau,0,1,0,1
2013,Abril,Panamá,1024,1617,0,2641
2013,Abril,Paraguay,131,173,0,304
2013,Abril,Perú,3511,5008,0,8519
2013,Abril,Palestina,4,3,0,7
2013,Abril,Polonia,71,146,0,217
2013,Abril,Portugal,142,460,0,602
2013,Abril,Puerto Rico/Territorio de Estados Unidos,0,2,0,2
2013,Abril,Qatar,0,2,0,2
2013,Abril,Reino Unido de Gran Bretaña e Irlanda del Norte,577,1387,0,1964
2013,Abril,República CentroÁfricana,0,2,0,2
2013,Abril,Federación de Rusia,159,272,0,431
2013,Abril,República Dominicana,308,507,0,815
2013,Abril,Rumania,27,82,0,109
2013,Abril,San Cristóbal y Nevis,0,1,0,1
2013,Abril,San  Vicente y las Granadinas,1,2,0,3
2013,Abril,Santa Lucia,3,3,0,6
2013,Abril,Senegal,0,2,0,2
2013,Abril,Serbia,5,6,0,11
2013,Abril,Singapur,8,13,0,21
2013,Abril,República Árabe Siria,0,1,0,1
2013,Abril,Sri Lanka,2,1,0,3
2013,Abril,Sudáfrica,53,162,0,215
2013,Abril,Suecia,147,241,0,388
2013,Abril,Suiza,312,545,0,857
2013,Abril,Surinam,17,34,0,51
2013,Abril,Suazilandia,1,0,0,1
2013,Abril,Taiwán,45,81,0,126
2013,Abril,Tailandia,4,10,0,14
2013,Abril,Tíbet/Región Autónoma de China,1,4,0,5
2013,Abril,Territorio Antártico Británico/Territorio Británico de Ultramar,0,9,0,9
2013,Abril,Tanzania,0,2,0,2
2013,Abril,Trinidad y Tobago,17,75,0,92
2013,Abril,Túnez,1,3,0,4
2013,Abril,Turquía,32,83,0,115
2013,Abril,Ucrania,20,29,0,49
2013,Abril,Uganda,0,3,0,3
2013,Abril,Uruguay,313,482,0,795
2013,Abril,Venezuela,7131,9698,0,16829
2013,Abril,Vietnam,2,3,0,5
2013,Abril,Islas Vírgenes Británicas/Territorio Británico de Ultramar,0,1,0,1
2013,Abril,República Árabe de Yemen,1,1,0,2
2013,Abril,Yugoslavia,1,0,0,1
2013,Abril,Zambia,4,3,0,7
2013,Abril,Zimbabue,0,5,0,5
2013,Abril,Desconocido,1,0,0,1
2013,Mayo,Albania,1,1,0,2
2013,Mayo,Alemania,1163,1906,0,3069
2013,Mayo,Andorra,2,12,0,14
2013,Mayo,Angola,1,2,0,3
2013,Mayo,Antigua y Barbuda,0,2,0,2
2013,Mayo,Países Bajos,829,1471,0,2300
2013,Mayo,Arabia Saudita,1,6,0,7
2013,Mayo,Argelia,0,2,0,2
2013,Mayo,Argentina,4153,5667,0,9820
2013,Mayo,República de Armenia,0,2,0,2
2013,Mayo,Aruba,4,2,0,6
2013,Mayo,Australia,289,520,0,809
2013,Mayo,Austria,68,173,0,241
2013,Mayo,Azerbaiyán,0,3,0,3
2013,Mayo,Bahamas,9,20,0,29
2013,Mayo,Bahréin,1,0,0,1
2013,Mayo,Bangladesh,1,5,0,6
2013,Mayo,Barbados,2,4,0,6
2013,Mayo,República de Belarús,2,7,0,9
2013,Mayo,Bélgica,95,334,0,429
2013,Mayo,Belice,7,16,0,23
2013,Mayo,Benín,0,1,0,1
2013,Mayo,Bermudas/Territorio Británico de Ultramar,0,2,0,2
2013,Mayo,Bolivia,317,544,0,861
2013,Mayo,Bosnia y Herzegovina,1,1,0,2
2013,Mayo,Botsuana,1,1,0,2
2013,Mayo,Brasil,2979,4690,0,7669
2013,Mayo,Bulgaria,8,9,0,17
2013,Mayo,Burundi,0,1,0,1
2013,Mayo,Bután,1,1,0,2
2013,Mayo,Cabo Verde,0,1,0,1
2013,Mayo,Islas Caimán/Territorio Británico de Ultramar,2,1,0,3
2013,Mayo,Camerún,1,0,0,1
2013,Mayo,Canadá,828,1751,0,2579
2013,Mayo,España,2067,5680,0,7747
2013,Mayo,República Democrática del Congo,2,2,0,4
2013,Mayo,República de Corea,146,496,0,642
2013,Mayo,Costa de Marfil,0,1,0,1
2013,Mayo,Costa Rica,805,1312,0,2117
2013,Mayo,Croacia,2,24,0,26
2013,Mayo,Cuba,123,226,0,349
2013,Mayo,Curazao,6,6,0,12
2013,Mayo,República Checa,24,39,0,63
2013,Mayo,Chile,3196,4380,0,7576
2013,Mayo,China,175,606,0,781
2013,Mayo,Chipre,0,3,0,3
2013,Mayo,Dinamarca,70,114,0,184
2013,Mayo,Dominica,1,4,0,5
2013,Mayo,Ecuador,3846,5775,0,9621
2013,Mayo,Egipto,5,17,0,22
2013,Mayo,El Salvador,487,803,0,1290
2013,Mayo,Emiratos Árabes,4,2,0,6
2013,Mayo,Eslovaquia,17,11,0,28
2013,Mayo,Eslovenia,10,24,0,34
2013,Mayo,Estados Unidos de América,9229,18287,0,27516
2013,Mayo,Estonia,12,8,0,20
2013,Mayo,Etiopia,1,4,0,5
2013,Mayo,Filipinas,16,151,0,167
2013,Mayo,Finlandia,50,108,0,158
2013,Mayo,Francia,878,1868,0,2746
2013,Mayo,Georgia,2,0,0,2
2013,Mayo,Ghana,1,3,0,4
2013,Mayo,Granada,0,2,0,2
2013,Mayo,Grecia,20,66,0,86
2013,Mayo,Guatemala,271,700,0,971
2013,Mayo,Guyana,6,15,0,21
2013,Mayo,Haití,5,28,0,33
2013,Mayo,Honduras,150,278,0,428
2013,Mayo,Hungría,19,22,0,41
2013,Mayo,India,43,309,0,352
2013,Mayo,Indonesia,14,30,0,44
2013,Mayo,Iraq,1,1,0,2
2013,Mayo,Irán,1,10,0,11
2013,Mayo,República de Irlanda,60,138,0,198
2013,Mayo,Islandia,10,10,0,20
2013,Mayo,Isla de Man,76,168,0,244
2013,Mayo,Israel,157,736,0,893
2013,Mayo,Islas Aland/Provincia de Finlandia,0,2,0,2
2013,Mayo,Italia,438,1709,0,2147
2013,Mayo,Islas del Canal,1,5,0,6
2013,Mayo,Jamaica,15,32,0,47
2013,Mayo,Japón,113,516,0,629
2013,Mayo,Jordania,1,7,0,8
2013,Mayo,Kazajistán,1,0,0,1
2013,Mayo,Kenia,5,3,0,8
2013,Mayo,Kirguistán,0,1,0,1
2013,Mayo,Kuwait,1,3,0,4
2013,Mayo,República de Kosovo,2,0,0,2
2013,Mayo,Letonia,5,17,0,22
2013,Mayo,Lituania,11,15,0,26
2013,Mayo,Líbano,19,32,0,51
2013,Mayo,Liechtenstein,0,1,0,1
2013,Mayo,Luxemburgo,1,8,0,9
2013,Mayo,Macedonia,1,2,0,3
2013,Mayo,Malasia,8,35,0,43
2013,Mayo,Malta,0,8,0,8
2013,Mayo,Marruecos,2,7,0,9
2013,Mayo,Mauricio,1,1,0,2
2013,Mayo,México,2193,5313,0,7506
2013,Mayo,República de Moldavia,0,1,0,1
2013,Mayo,Mozambique,1,1,0,2
2013,Mayo,Nepal,1,2,0,3
2013,Mayo,Nicaragua,58,84,0,142
2013,Mayo,Nigeria,4,26,0,30
2013,Mayo,Noruega,54,88,0,142
2013,Mayo,Nueva Zelanda,40,98,0,138
2013,Mayo,Omán,4,4,0,8
2013,Mayo,Pakistán,0,8,0,8
2013,Mayo,Palau,0,1,0,1
2013,Mayo,Panamá,1276,1889,0,3165
2013,Mayo,Paraguay,109,146,0,255
2013,Mayo,Perú,3872,4828,0,8700
2013,Mayo,Palestina,0,4,0,4
2013,Mayo,Polonia,59,108,0,167
2013,Mayo,Portugal,204,510,0,714
2013,Mayo,Puerto Rico/Territorio de Estados Unidos,4,0,0,4
2013,Mayo,Qatar,0,2,0,2
2013,Mayo,Reino Unido de Gran Bretaña e Irlanda del Norte,592,1366,0,1958
2013,Mayo,Federación de Rusia,112,204,0,316
2013,Mayo,República Dominicana,304,551,0,855
2013,Mayo,Rumania,31,58,0,89
2013,Mayo,San Cristóbal y Nevis,3,2,0,5
2013,Mayo,San  Vicente y las Granadinas,0,1,0,1
2013,Mayo,Santa Lucia,2,1,0,3
2013,Mayo,Santa Sede/Ciudad del Vaticano,0,3,0,3
2013,Mayo,Senegal,0,1,0,1
2013,Mayo,Serbia,4,10,0,14
2013,Mayo,Singapur,13,17,0,30
2013,Mayo,República Árabe Siria,0,1,0,1
2013,Mayo,Sri Lanka,3,5,0,8
2013,Mayo,Sudáfrica,34,81,0,115
2013,Mayo,Suecia,117,206,0,323
2013,Mayo,Suiza,334,593,0,927
2013,Mayo,Surinam,12,25,0,37
2013,Mayo,Taiwán,40,86,0,126
2013,Mayo,Tailandia,8,8,0,16
2013,Mayo,Tíbet/Región Autónoma de China,2,1,0,3
2013,Mayo,Territorio Antártico Británico/Territorio Británico de Ultramar,1,1,0,2
2013,Mayo,Tanzania,0,4,0,4
2013,Mayo,Togo,0,3,0,3
2013,Mayo,Trinidad y Tobago,17,61,0,78
2013,Mayo,Túnez,0,3,0,3
2013,Mayo,Turkmenistán,1,0,0,1
2013,Mayo,Turquía,24,88,0,112
2013,Mayo,Ucrania,14,24,0,38
2013,Mayo,Uganda,1,2,0,3
2013,Mayo,Uruguay,393,556,0,949
2013,Mayo,Uzbekistán,0,1,0,1
2013,Mayo,Venezuela,7198,9946,0,17144
2013,Mayo,Vietnam,0,13,0,13
2013,Mayo,Islas Vírgenes Británicas/Territorio Británico de Ultramar,0,1,0,1
2013,Mayo,Zimbabue,0,4,0,4
2013,Mayo,Islas Turcas y Caicos/Territorio Británico de Ultramar,1,1,0,2
2013,Junio,Afganistán,0,3,0,3
2013,Junio,Albania,1,4,0,5
2013,Junio,Alemania,1169,1828,0,2997
2013,Junio,Andorra,0,12,0,12
2013,Junio,Angola,1,2,0,3
2013,Junio,Antigua y Barbuda,0,2,0,2
2013,Junio,Países Bajos,993,1467,0,2460
2013,Junio,Arabia Saudita,1,11,0,12
2013,Junio,Argelia,1,3,0,4
2013,Junio,Argentina,4013,5544,0,9557
2013,Junio,Aruba,4,6,0,10
2013,Junio,Australia,310,516,0,826
2013,Junio,Austria,84,202,0,286
2013,Junio,Azerbaiyán,1,2,0,3
2013,Junio,Bahamas,6,5,0,11
2013,Junio,Bangladesh,1,3,0,4
2013,Junio,Barbados,5,10,0,15
2013,Junio,República de Belarús,4,4,0,8
2013,Junio,Bélgica,201,377,0,578
2013,Junio,Belice,3,17,0,20
2013,Junio,Bermudas/Territorio Británico de Ultramar,1,3,0,4
2013,Junio,Bolivia,351,569,0,920
2013,Junio,Bosnia y Herzegovina,2,8,0,10
2013,Junio,Botsuana,0,2,0,2
2013,Junio,Brasil,2714,4238,0,6952
2013,Junio,Bulgaria,10,9,0,19
2013,Junio,Burkina Faso,1,1,0,2
2013,Junio,Cabo Verde,0,2,0,2
2013,Junio,Islas Caimán/Territorio Británico de Ultramar,3,5,0,8
2013,Junio,Camerún,2,4,0,6
2013,Junio,Canadá,901,1579,0,2480
2013,Junio,España,2576,5928,0,8504
2013,Junio,República Democrática del Congo,1,2,0,3
2013,Junio,República de Corea,131,390,0,521
2013,Junio,Costa de Marfil,0,4,0,4
2013,Junio,Costa Rica,867,1354,0,2221
2013,Junio,Croacia,6,33,0,39
2013,Junio,Cuba,123,218,0,341
2013,Junio,Curazao,5,6,0,11
2013,Junio,República Checa,32,44,0,76
2013,Junio,Chile,2787,4216,0,7003
2013,Junio,China,182,473,0,655
2013,Junio,Chipre,0,3,0,3
2013,Junio,Dinamarca,70,152,0,222
2013,Junio,Dominica,0,5,0,5
2013,Junio,Ecuador,3163,5452,0,8615
2013,Junio,Egipto,2,15,0,17
2013,Junio,El Salvador,468,780,0,1248
2013,Junio,Emiratos Árabes,2,12,0,14
2013,Junio,Eslovaquia,11,26,0,37
2013,Junio,Eslovenia,11,27,0,38
2013,Junio,Estados Unidos de América,14736,22452,0,37188
2013,Junio,Estonia,5,1,0,6
2013,Junio,Etiopia,0,4,0,4
2013,Junio,Filipinas,20,176,0,196
2013,Junio,Finlandia,44,48,0,92
2013,Junio,Francia,1032,1862,0,2894
2013,Junio,Georgia,1,1,0,2
2013,Junio,Granada,0,3,0,3
2013,Junio,Grecia,16,65,0,81
2013,Junio,Guatemala,369,807,0,1176
2013,Junio,Guyana,10,19,0,29
2013,Junio,Guayana Francesa/Departamento de Ultramar Francés,0,1,0,1
2013,Junio,Haití,9,14,0,23
2013,Junio,Honduras,181,303,0,484
2013,Junio,Hong Kong,2,0,0,2
2013,Junio,Hungría,12,18,0,30
2013,Junio,India,48,303,0,351
2013,Junio,Indonesia,10,37,0,47
2013,Junio,Iraq,0,1,0,1
2013,Junio,Irán,9,17,0,26
2013,Junio,República de Irlanda,137,160,0,297
2013,Junio,Islandia,6,4,0,10
2013,Junio,Isla de Man,75,163,0,238
2013,Junio,Isla Johnston,0,1,0,1
2013,Junio,Israel,138,557,0,695
2013,Junio,Isla Wake,12,5,0,17
2013,Junio,Italia,544,1624,0,2168
2013,Junio,Islas del Canal,1,2,0,3
2013,Junio,Jamaica,22,48,0,70
2013,Junio,Japón,115,492,0,607
2013,Junio,Jordania,1,3,0,4
2013,Junio,Kazajistán,4,2,0,6
2013,Junio,Kenia,4,10,0,14
2013,Junio,Kirguistán,0,1,0,1
2013,Junio,Kuwait,1,3,0,4
2013,Junio,República de Kosovo,0,1,0,1
2013,Junio,Letonia,10,5,0,15
2013,Junio,Lituania,13,18,0,31
2013,Junio,Líbano,20,45,0,65
2013,Junio,Libia,0,1,0,1
2013,Junio,Luxemburgo,1,6,0,7
2013,Junio,Macedonia,0,3,0,3
2013,Junio,Madagascar,0,1,0,1
2013,Junio,Malasia,10,24,0,34
2013,Junio,Malí,0,1,0,1
2013,Junio,Malta,1,1,0,2
2013,Junio,Marruecos,3,10,0,13
2013,Junio,Mauricio,1,1,0,2
2013,Junio,México,2290,5358,0,7648
2013,Junio,República de Moldavia,2,1,0,3
2013,Junio,Mónaco,0,1,0,1
2013,Junio,Montenegro,0,1,0,1
2013,Junio,Mozambique,0,2,0,2
2013,Junio,Myanmar,2,3,0,5
2013,Junio,Nepal,4,6,0,10
2013,Junio,Nicaragua,69,88,0,157
2013,Junio,Nigeria,2,2,0,4
2013,Junio,Noruega,104,163,0,267
2013,Junio,Nueva Zelanda,43,95,0,138
2013,Junio,Pakistán,2,11,0,13
2013,Junio,Panamá,885,1522,0,2407
2013,Junio,Paraguay,158,292,0,450
2013,Junio,Perú,2866,4633,0,7499
2013,Junio,Palestina,1,2,0,3
2013,Junio,Polonia,63,80,0,143
2013,Junio,Portugal,97,344,0,441
2013,Junio,Puerto Rico/Territorio de Estados Unidos,3,1,0,4
2013,Junio,Qatar,1,5,0,6
2013,Junio,Reino Unido de Gran Bretaña e Irlanda del Norte,662,1326,0,1988
2013,Junio,Federación de Rusia,113,179,0,292
2013,Junio,República Dominicana,301,576,0,877
2013,Junio,Rumania,32,73,0,105
2013,Junio,Rwanda,0,2,0,2
2013,Junio,San Cristóbal y Nevis,1,6,0,7
2013,Junio,Samoa Occidental,1,0,0,1
2013,Junio,San  Vicente y las Granadinas,1,6,0,7
2013,Junio,Santa Lucia,3,4,0,7
2013,Junio,Senegal,1,1,0,2
2013,Junio,Serbia,5,10,0,15
2013,Junio,Singapur,16,24,0,40
2013,Junio,República Árabe Siria,2,2,0,4
2013,Junio,Sri Lanka,1,3,0,4
2013,Junio,Sudáfrica,33,84,0,117
2013,Junio,Suecia,198,298,0,496
2013,Junio,Suiza,338,601,0,939
2013,Junio,Surinam,14,17,0,31
2013,Junio,Taiwán,58,87,0,145
2013,Junio,República de Tayikistán,0,1,0,1
2013,Junio,Tailandia,2,4,0,6
2013,Junio,Territorio Antártico Británico/Territorio Británico de Ultramar,2,2,0,4
2013,Junio,Tanzania,0,2,0,2
2013,Junio,Trinidad y Tobago,30,71,0,101
2013,Junio,Túnez,2,2,0,4
2013,Junio,Turquía,29,98,0,127
2013,Junio,Ucrania,20,19,0,39
2013,Junio,Uganda,0,3,0,3
2013,Junio,Uruguay,397,614,0,1011
2013,Junio,Venezuela,7776,10379,0,18155
2013,Junio,Vietnam,1,1,0,2
2013,Junio,República Árabe de Yemen,0,1,0,1
2013,Junio,Zambia,0,1,0,1
2013,Junio,Zimbabue,0,2,0,2
2013,Junio,Desconocido,0,2,0,2
2013,Julio,Afganistán,0,2,0,2
2013,Julio,Albania,2,2,0,4
2013,Julio,Alemania,1857,2689,0,4546
2013,Julio,Andorra,2,12,0,14
2013,Julio,Angola,1,2,0,3
2013,Julio,Antigua y Barbuda,2,3,0,5
2013,Julio,Países Bajos,1717,2257,0,3974
2013,Julio,Arabia Saudita,3,16,0,19
2013,Julio,Argelia,2,8,0,10
2013,Julio,Argentina,4547,5987,0,10534
2013,Julio,República de Armenia,0,9,0,9
2013,Julio,Aruba,7,3,0,10
2013,Julio,Australia,396,664,0,1060
2013,Julio,Austria,246,337,0,583
2013,Julio,Azerbaiyán,2,14,0,16
2013,Julio,Bahamas,7,12,0,19
2013,Julio,Bangladesh,1,10,0,11
2013,Julio,Barbados,24,21,0,45
2013,Julio,República de Belarús,23,17,0,40
2013,Julio,Bélgica,345,597,0,942
2013,Julio,Belice,18,16,0,34
2013,Julio,Benín,1,0,0,1
2013,Julio,Bermudas/Territorio Británico de Ultramar,1,6,0,7
2013,Julio,Bolivia,406,582,0,988
2013,Julio,Bosnia y Herzegovina,2,7,0,9
2013,Julio,Brasil,3646,5170,0,8816
2013,Julio,Bulgaria,19,20,0,39
2013,Julio,Burkina Faso,2,1,0,3
2013,Julio,Islas Caimán/Territorio Británico de Ultramar,5,3,0,8
2013,Julio,Camboya,0,1,0,1
2013,Julio,Camerún,0,3,0,3
2013,Julio,Canadá,1200,2086,0,3286
2013,Julio,España,2668,5996,0,8664
2013,Julio,República Del Congo,0,2,0,2
2013,Julio,República Democrática del Congo,1,4,0,5
2013,Julio,República de Corea,172,433,0,605
2013,Julio,Costa de Marfil,1,1,0,2
2013,Julio,Costa Rica,1262,1597,0,2859
2013,Julio,Croacia,13,56,0,69
2013,Julio,Cuba,183,347,0,530
2013,Julio,Curazao,4,7,0,11
2013,Julio,República Checa,59,148,0,207
2013,Julio,Chile,4004,4910,0,8914
2013,Julio,China,284,549,0,833
2013,Julio,Chipre,1,18,0,19
2013,Julio,Dinamarca,119,220,0,339
2013,Julio,Dominica,0,4,0,4
2013,Julio,Ecuador,4494,6612,0,11106
2013,Julio,Egipto,11,31,0,42
2013,Julio,El Salvador,598,949,0,1547
2013,Julio,Emiratos Árabes,1,2,0,3
2013,Julio,Eritrea,1,1,0,2
2013,Julio,Eslovaquia,25,38,0,63
2013,Julio,Eslovenia,21,41,0,62
2013,Julio,Estados Unidos de América,14084,22289,0,36373
2013,Julio,Estonia,17,27,0,44
2013,Julio,Etiopia,3,0,0,3
2013,Julio,Filipinas,29,321,0,350
2013,Julio,Finlandia,58,66,0,124
2013,Julio,Francia,1891,3138,0,5029
2013,Julio,Georgia,2,9,0,11
2013,Julio,Ghana,1,1,0,2
2013,Julio,Granada,2,3,0,5
2013,Julio,Grecia,14,80,0,94
2013,Julio,Guatemala,356,808,0,1164
2013,Julio,Guyana,9,16,0,25
2013,Julio,Guinea,0,1,0,1
2013,Julio,Guinea Ecuatorial,2,1,0,3
2013,Julio,Guinea Bissau,0,1,0,1
2013,Julio,Haití,7,20,0,27
2013,Julio,Honduras,241,368,0,609
2013,Julio,Hungría,72,89,0,161
2013,Julio,India,65,346,0,411
2013,Julio,Indonesia,16,45,0,61
2013,Julio,Iraq,0,1,0,1
2013,Julio,Irán,8,44,0,52
2013,Julio,República de Irlanda,153,229,0,382
2013,Julio,Islandia,5,12,0,17
2013,Julio,Isla de Man,147,273,0,420
2013,Julio,Islas Pitcairn/Territorio Británico de Ultramar,0,1,0,1
2013,Julio,Isla Johnston,2,0,0,2
2013,Julio,Israel,157,666,0,823
2013,Julio,Islas Aland/Provincia de Finlandia,0,1,0,1
2013,Julio,Isla Wake,4,2,0,6
2013,Julio,Italia,731,1985,0,2716
2013,Julio,Islas del Canal,1,7,0,8
2013,Julio,Jamaica,39,37,0,76
2013,Julio,Islas Salomón,1,0,0,1
2013,Julio,Japón,198,632,0,830
2013,Julio,Jordania,3,8,0,11
2013,Julio,Kazajistán,5,12,0,17
2013,Julio,Kenia,8,10,0,18
2013,Julio,Kirguistán,1,10,0,11
2013,Julio,Kuwait,0,1,0,1
2013,Julio,República de Kosovo,1,8,0,9
2013,Julio,Letonia,14,59,0,73
2013,Julio,Lituania,20,25,0,45
2013,Julio,Líbano,25,33,0,58
2013,Julio,Liechtenstein,5,5,0,10
2013,Julio,Luxemburgo,9,25,0,34
2013,Julio,Macedonia,2,11,0,13
2013,Julio,Madagascar,2,1,0,3
2013,Julio,Malasia,19,50,0,69
2013,Julio,Malta,1,4,0,5
2013,Julio,Marruecos,5,18,0,23
2013,Julio,Mauricio,1,4,0,5
2013,Julio,Mauritania,0,1,0,1
2013,Julio,México,3969,7120,0,11089
2013,Julio,Mayotte/Colectividad Territorial Francesa,0,1,0,1
2013,Julio,República de Moldavia,4,5,0,9
2013,Julio,Mónaco,1,0,0,1
2013,Julio,Mongolia,5,25,0,30
2013,Julio,Montenegro,6,7,0,13
2013,Julio,Namibia,0,1,0,1
2013,Julio,Nepal,1,1,0,2
2013,Julio,Nicaragua,88,109,0,197
2013,Julio,Nigeria,5,12,0,17
2013,Julio,Noruega,180,269,0,449
2013,Julio,Nueva Caledonia/Territorio francés,1,0,0,1
2013,Julio,Nueva Zelanda,84,129,0,213
2013,Julio,Papúa Nueva Guinea,1,1,0,2
2013,Julio,Pakistán,3,19,0,22
2013,Julio,Panamá,1069,1843,0,2912
2013,Julio,Paraguay,170,421,0,591
2013,Julio,Perú,3985,5070,0,9055
2013,Julio,Palestina,1,1,0,2
2013,Julio,Polonia,110,179,0,289
2013,Julio,Portugal,143,449,0,592
2013,Julio,Puerto Rico/Territorio de Estados Unidos,1,3,0,4
2013,Julio,Qatar,0,16,0,16
2013,Julio,Reino Unido de Gran Bretaña e Irlanda del Norte,1004,1895,0,2899
2013,Julio,República CentroÁfricana,0,2,0,2
2013,Julio,Federación de Rusia,220,372,0,592
2013,Julio,República Dominicana,343,620,0,963
2013,Julio,República Democrática Popular de Corea,0,8,0,8
2013,Julio,Rumania,55,67,0,122
2013,Julio,San Cristóbal y Nevis,1,4,0,5
2013,Julio,San  Vicente y las Granadinas,0,5,0,5
2013,Julio,Santa Lucia,3,11,0,14
2013,Julio,Santa Sede/Ciudad del Vaticano,0,3,0,3
2013,Julio,Santo Tomé y Príncipe,0,1,0,1
2013,Julio,Senegal,2,5,0,7
2013,Julio,Serbia,11,20,0,31
2013,Julio,Singapur,24,44,0,68
2013,Julio,República Árabe Siria,0,4,0,4
2013,Julio,Sri Lanka,3,10,0,13
2013,Julio,Sudáfrica,59,136,0,195
2013,Julio,Suecia,167,323,0,490
2013,Julio,Suiza,737,1097,0,1834
2013,Julio,Surinam,8,33,0,41
2013,Julio,Taiwán,100,146,0,246
2013,Julio,República de Tayikistán,0,1,0,1
2013,Julio,Tailandia,18,30,0,48
2013,Julio,Tíbet/Región Autónoma de China,2,1,0,3
2013,Julio,Territorio Antártico Británico/Territorio Británico de Ultramar,4,5,0,9
2013,Julio,Tanzania,0,2,0,2
2013,Julio,República Democrática de Timor Oriental,0,1,0,1
2013,Julio,Trinidad y Tobago,102,138,0,240
2013,Julio,Túnez,7,13,0,20
2013,Julio,Turkmenistán,0,13,0,13
2013,Julio,Turquía,38,127,0,165
2013,Julio,Ucrania,88,131,0,219
2013,Julio,Uganda,4,10,0,14
2013,Julio,Uruguay,316,546,0,862
2013,Julio,Venezuela,10132,12499,0,22631
2013,Julio,Vietnam,10,24,0,34
2013,Julio,Zambia,0,1,0,1
2013,Julio,Zimbabue,1,1,0,2
2013,Julio,Desconocido,0,1,0,1
2013,Agosto,Albania,3,5,0,8
2013,Agosto,Alemania,1879,2572,0,4451
2013,Agosto,Andorra,3,15,0,18
2013,Agosto,Angola,1,1,0,2
2013,Agosto,Antigua y Barbuda,1,4,0,5
2013,Agosto,Países Bajos,881,1380,0,2261
2013,Agosto,Arabia Saudita,0,5,0,5
2013,Agosto,Argelia,1,2,0,3
2013,Agosto,Argentina,4400,5984,0,10384
2013,Agosto,República de Armenia,1,2,0,3
2013,Agosto,Aruba,4,4,0,8
2013,Agosto,Australia,331,533,0,864
2013,Agosto,Austria,179,265,0,444
2013,Agosto,Azerbaiyán,0,2,0,2
2013,Agosto,Bahamas,8,16,0,24
2013,Agosto,Bangladesh,1,2,0,3
2013,Agosto,Barbados,8,14,0,22
2013,Agosto,República de Belarús,3,2,0,5
2013,Agosto,Bélgica,174,355,0,529
2013,Agosto,Belice,11,18,0,29
2013,Agosto,Bermudas/Territorio Británico de Ultramar,0,3,0,3
2013,Agosto,Bolivia,383,515,0,898
2013,Agosto,Bosnia y Herzegovina,4,0,0,4
2013,Agosto,Botsuana,1,0,0,1
2013,Agosto,Brasil,3137,4716,0,7853
2013,Agosto,Bulgaria,10,18,0,28
2013,Agosto,Burkina Faso,0,1,0,1
2013,Agosto,Burundi,1,4,0,5
2013,Agosto,Bután,1,0,0,1
2013,Agosto,Islas Caimán/Territorio Británico de Ultramar,4,2,0,6
2013,Agosto,Camboya,3,4,0,7
2013,Agosto,Canadá,1100,1818,0,2918
2013,Agosto,España,3122,5953,0,9075
2013,Agosto,República Democrática del Congo,5,6,0,11
2013,Agosto,República de Corea,271,491,0,762
2013,Agosto,Costa de Marfil,0,1,0,1
2013,Agosto,Costa Rica,1009,1400,0,2409
2013,Agosto,Croacia,10,25,0,35
2013,Agosto,Cuba,167,339,0,506
2013,Agosto,Curazao,7,3,0,10
2013,Agosto,República Checa,29,46,0,75
2013,Agosto,Chile,3395,4557,0,7952
2013,Agosto,China,189,427,0,616
2013,Agosto,Chipre,0,5,0,5
2013,Agosto,Dinamarca,62,125,0,187
2013,Agosto,Dominica,1,3,0,4
2013,Agosto,Ecuador,4718,6312,0,11030
2013,Agosto,Egipto,6,15,0,21
2013,Agosto,El Salvador,726,934,0,1660
2013,Agosto,Emiratos Árabes,1,10,0,11
2013,Agosto,Eslovaquia,17,18,0,35
2013,Agosto,Eslovenia,20,18,0,38
2013,Agosto,Estados Unidos de América,11403,20544,0,31947
2013,Agosto,Estonia,5,6,0,11
2013,Agosto,Etiopia,2,6,0,8
2013,Agosto,Islas Fiji,1,0,0,1
2013,Agosto,Filipinas,19,214,0,233
2013,Agosto,Finlandia,32,67,0,99
2013,Agosto,Francia,1634,2786,0,4420
2013,Agosto,Gabón,2,2,0,4
2013,Agosto,Georgia,4,1,0,5
2013,Agosto,Ghana,3,4,0,7
2013,Agosto,Granada,0,2,0,2
2013,Agosto,Grecia,34,61,0,95
2013,Agosto,Guatemala,306,720,0,1026
2013,Agosto,Guyana,5,14,0,19
2013,Agosto,Guinea,0,1,0,1
2013,Agosto,Guinea Bissau,0,1,0,1
2013,Agosto,Guayana Francesa/Departamento de Ultramar Francés,0,1,0,1
2013,Agosto,Haití,6,16,0,22
2013,Agosto,Honduras,258,350,0,608
2013,Agosto,Hong Kong,0,1,0,1
2013,Agosto,Hungría,24,28,0,52
2013,Agosto,India,73,332,0,405
2013,Agosto,Indonesia,20,25,0,45
2013,Agosto,Iraq,2,19,0,21
2013,Agosto,Irán,9,12,0,21
2013,Agosto,República de Irlanda,110,175,0,285
2013,Agosto,Islandia,5,2,0,7
2013,Agosto,Isla de Man,86,177,0,263
2013,Agosto,Isla Johnston,1,1,0,2
2013,Agosto,Israel,171,589,0,760
2013,Agosto,Islas Aland/Provincia de Finlandia,1,0,0,1
2013,Agosto,Isla Wake,2,1,0,3
2013,Agosto,Italia,873,2251,0,3124
2013,Agosto,Islas del Canal,2,8,0,10
2013,Agosto,Jamaica,24,43,0,67
2013,Agosto,Japón,173,560,0,733
2013,Agosto,Jordania,1,2,0,3
2013,Agosto,Kazajistán,1,0,0,1
2013,Agosto,Kenia,6,10,0,16
2013,Agosto,Kirguistán,1,1,0,2
2013,Agosto,Kuwait,0,2,0,2
2013,Agosto,República Democrática Popular  Lao,2,2,0,4
2013,Agosto,Letonia,6,4,0,10
2013,Agosto,Lituania,10,7,0,17
2013,Agosto,Líbano,15,35,0,50
2013,Agosto,Liberia,1,0,0,1
2013,Agosto,Libia,2,0,0,2
2013,Agosto,Liechtenstein,1,1,0,2
2013,Agosto,Luxemburgo,7,16,0,23
2013,Agosto,Macedonia,2,2,0,4
2013,Agosto,Madagascar,0,1,0,1
2013,Agosto,Malasia,13,20,0,33
2013,Agosto,Malawi,0,1,0,1
2013,Agosto,Maldivas,0,1,0,1
2013,Agosto,Malta,3,1,0,4
2013,Agosto,Marruecos,2,8,0,10
2013,Agosto,Mauritania,0,2,0,2
2013,Agosto,México,3144,6510,0,9654
2013,Agosto,Mayotte/Colectividad Territorial Francesa,0,1,0,1
2013,Agosto,Mónaco,4,4,0,8
2013,Agosto,Mongolia,0,1,0,1
2013,Agosto,Montenegro,1,0,0,1
2013,Agosto,Mozambique,0,1,0,1
2013,Agosto,Myanmar,2,3,0,5
2013,Agosto,Namibia,0,1,0,1
2013,Agosto,Nepal,1,1,0,2
2013,Agosto,Nicaragua,66,138,0,204
2013,Agosto,Nigeria,1,8,0,9
2013,Agosto,Noruega,53,111,0,164
2013,Agosto,Nueva Zelanda,66,117,0,183
2013,Agosto,Papúa Nueva Guinea,0,1,0,1
2013,Agosto,Pakistán,4,13,0,17
2013,Agosto,Panamá,1097,1877,0,2974
2013,Agosto,Paraguay,117,175,0,292
2013,Agosto,Perú,4183,5447,0,9630
2013,Agosto,Palestina,2,1,0,3
2013,Agosto,Polonia,106,126,0,232
2013,Agosto,Portugal,134,363,0,497
2013,Agosto,Puerto Rico/Territorio de Estados Unidos,1,1,0,2
2013,Agosto,Qatar,0,1,0,1
2013,Agosto,Reino Unido de Gran Bretaña e Irlanda del Norte,774,1533,0,2307
2013,Agosto,Federación de Rusia,134,155,0,289
2013,Agosto,República Dominicana,386,645,0,1031
2013,Agosto,Rumania,30,62,0,92
2013,Agosto,Rwanda,2,1,0,3
2013,Agosto,San Cristóbal y Nevis,2,12,0,14
2013,Agosto,San  Vicente y las Granadinas,1,5,0,6
2013,Agosto,Santa Lucia,3,1,0,4
2013,Agosto,Santa Sede/Ciudad del Vaticano,0,2,0,2
2013,Agosto,Senegal,0,5,0,5
2013,Agosto,Serbia,7,9,0,16
2013,Agosto,Singapur,8,28,0,36
2013,Agosto,República Árabe Siria,1,8,0,9
2013,Agosto,Sri Lanka,0,3,0,3
2013,Agosto,Sudáfrica,47,100,0,147
2013,Agosto,Sudán,0,1,0,1
2013,Agosto,Suecia,117,188,0,305
2013,Agosto,Suiza,365,555,0,920
2013,Agosto,Surinam,46,27,0,73
2013,Agosto,Taiwán,71,93,0,164
2013,Agosto,Tailandia,6,11,0,17
2013,Agosto,Territorio Antártico Británico/Territorio Británico de Ultramar,1,4,0,5
2013,Agosto,Trinidad y Tobago,35,69,0,104
2013,Agosto,Túnez,2,5,0,7
2013,Agosto,Turquía,34,79,0,113
2013,Agosto,Ucrania,18,40,0,58
2013,Agosto,Uganda,6,4,0,10
2013,Agosto,Uruguay,326,533,0,859
2013,Agosto,Uzbekistán,2,0,0,2
2013,Agosto,Venezuela,11545,13005,0,24550
2013,Agosto,Vietnam,1,8,0,9
2013,Agosto,Islas Vírgenes Británicas/Territorio Británico de Ultramar,0,1,0,1
2013,Agosto,República Árabe de Yemen,1,0,0,1
2013,Agosto,Zambia,1,1,0,2
2013,Agosto,Zimbabue,0,3,0,3
2013,Agosto,Anguila/Territorio Británico de Ultramar,0,1,0,1
2013,Agosto,Desconocido,0,1,0,1
2013,Septiembre,Albania,2,4,0,6
2013,Septiembre,Alemania,1243,2047,0,3290
2013,Septiembre,Andorra,1,5,0,6
2013,Septiembre,Antigua y Barbuda,4,9,0,13
2013,Septiembre,Países Bajos,819,1464,0,2283
2013,Septiembre,Arabia Saudita,0,14,0,14
2013,Septiembre,Argelia,1,3,0,4
2013,Septiembre,Argentina,4355,5669,0,10024
2013,Septiembre,República de Armenia,1,1,0,2
2013,Septiembre,Aruba,2,0,0,2
2013,Septiembre,Australia,278,508,0,786
2013,Septiembre,Austria,87,212,0,299
2013,Septiembre,Azerbaiyán,1,0,0,1
2013,Septiembre,Bahamas,4,15,0,19
2013,Septiembre,Bangladesh,1,6,0,7
2013,Septiembre,Barbados,11,20,0,31
2013,Septiembre,República de Belarús,2,7,0,9
2013,Septiembre,Bélgica,134,373,0,507
2013,Septiembre,Belice,4,27,0,31
2013,Septiembre,Benín,1,0,0,1
2013,Septiembre,Bermudas/Territorio Británico de Ultramar,0,3,0,3
2013,Septiembre,Bolivia,367,532,0,899
2013,Septiembre,Botsuana,1,2,0,3
2013,Septiembre,Brasil,3651,5250,0,8901
2013,Septiembre,Bulgaria,10,14,0,24
2013,Septiembre,Burkina Faso,2,9,0,11
2013,Septiembre,Islas Caimán/Territorio Británico de Ultramar,1,0,0,1
2013,Septiembre,Camerún,0,6,0,6
2013,Septiembre,Canadá,650,1561,0,2211
2013,Septiembre,Chad,0,2,0,2
2013,Septiembre,España,2279,6113,0,8392
2013,Septiembre,República Democrática del Congo,1,2,0,3
2013,Septiembre,República de Corea,126,408,0,534
2013,Septiembre,Costa de Marfil,1,7,0,8
2013,Septiembre,Costa Rica,949,1422,0,2371
2013,Septiembre,Croacia,6,30,0,36
2013,Septiembre,Cuba,120,266,0,386
2013,Septiembre,Curazao,2,4,0,6
2013,Septiembre,República Checa,33,48,0,81
2013,Septiembre,Chile,3516,4472,0,7988
2013,Septiembre,China,128,384,0,512
2013,Septiembre,Chipre,2,3,0,5
2013,Septiembre,Dinamarca,43,125,0,168
2013,Septiembre,Dominica,5,5,0,10
2013,Septiembre,Ecuador,3977,6571,0,10548
2013,Septiembre,Egipto,3,25,0,28
2013,Septiembre,El Salvador,535,865,0,1400
2013,Septiembre,Emiratos Árabes,1,9,0,10
2013,Septiembre,Eslovaquia,12,22,0,34
2013,Septiembre,Eslovenia,5,23,0,28
2013,Septiembre,Estados Unidos de América,6652,15413,0,22065
2013,Septiembre,Estonia,5,5,0,10
2013,Septiembre,Etiopia,3,7,0,10
2013,Septiembre,Filipinas,25,262,0,287
2013,Septiembre,Finlandia,28,65,0,93
2013,Septiembre,Francia,812,1776,0,2588
2013,Septiembre,Gabón,1,4,0,5
2013,Septiembre,Georgia,1,1,0,2
2013,Septiembre,Ghana,1,7,0,8
2013,Septiembre,Gibraltar/Territorio Británico de Ultramar,1,0,0,1
2013,Septiembre,Granada,5,2,0,7
2013,Septiembre,Grecia,26,70,0,96
2013,Septiembre,Guatemala,326,734,0,1060
2013,Septiembre,Guyana,13,20,0,33
2013,Septiembre,Guinea Ecuatorial,1,1,0,2
2013,Septiembre,Haití,11,37,0,48
2013,Septiembre,Honduras,230,347,0,577
2013,Septiembre,Hong Kong,0,1,0,1
2013,Septiembre,Hungría,23,34,0,57
2013,Septiembre,India,35,256,0,291
2013,Septiembre,Indonesia,10,38,0,48
2013,Septiembre,Iraq,0,1,0,1
2013,Septiembre,Irán,4,8,0,12
2013,Septiembre,República de Irlanda,87,179,0,266
2013,Septiembre,Islandia,2,34,0,36
2013,Septiembre,Isla de Man,41,88,0,129
2013,Septiembre,Isla Johnston,0,2,0,2
2013,Septiembre,Israel,104,426,0,530
2013,Septiembre,Italia,448,1655,0,2103
2013,Septiembre,Islas del Canal,1,7,0,8
2013,Septiembre,Jamaica,20,45,0,65
2013,Septiembre,Japón,135,500,0,635
2013,Septiembre,Jordania,0,5,0,5
2013,Septiembre,Kazajistán,4,6,0,10
2013,Septiembre,Kenia,9,17,0,26
2013,Septiembre,Kirguistán,0,1,0,1
2013,Septiembre,Kuwait,0,6,0,6
2013,Septiembre,República de Kosovo,1,0,0,1
2013,Septiembre,Letonia,9,9,0,18
2013,Septiembre,Lituania,18,12,0,30
2013,Septiembre,Líbano,25,35,0,60
2013,Septiembre,Liberia,1,0,0,1
2013,Septiembre,Liechtenstein,3,2,0,5
2013,Septiembre,Luxemburgo,3,9,0,12
2013,Septiembre,Macedonia,1,1,0,2
2013,Septiembre,Madagascar,0,1,0,1
2013,Septiembre,Malasia,13,28,0,41
2013,Septiembre,Malawi,1,2,0,3
2013,Septiembre,Malí,2,2,0,4
2013,Septiembre,Malta,4,2,0,6
2013,Septiembre,Marruecos,7,8,0,15
2013,Septiembre,Mauricio,1,0,0,1
2013,Septiembre,Mauritania,3,1,0,4
2013,Septiembre,México,2888,6164,0,9052
2013,Septiembre,República de Moldavia,4,0,0,4
2013,Septiembre,Mongolia,2,0,0,2
2013,Septiembre,Mozambique,2,3,0,5
2013,Septiembre,Namibia,2,5,0,7
2013,Septiembre,Nepal,0,3,0,3
2013,Septiembre,Nicaragua,77,131,0,208
2013,Septiembre,Nigeria,3,20,0,23
2013,Septiembre,Níger,0,5,0,5
2013,Septiembre,Noruega,40,120,0,160
2013,Septiembre,Nueva Zelanda,35,98,0,133
2013,Septiembre,Omán,0,1,0,1
2013,Septiembre,Pakistán,0,11,0,11
2013,Septiembre,Panamá,1171,1692,0,2863
2013,Septiembre,Paraguay,135,200,0,335
2013,Septiembre,Perú,3486,4744,0,8230
2013,Septiembre,Palestina,0,1,0,1
2013,Septiembre,Polonia,71,121,0,192
2013,Septiembre,Portugal,103,380,0,483
2013,Septiembre,Qatar,0,2,0,2
2013,Septiembre,Reino Unido de Gran Bretaña e Irlanda del Norte,577,1545,0,2122
2013,Septiembre,República CentroÁfricana,5,1,0,6
2013,Septiembre,Federación de Rusia,167,223,0,390
2013,Septiembre,República Dominicana,353,598,0,951
2013,Septiembre,República Democrática Popular de Corea,0,1,0,1
2013,Septiembre,Rumania,37,59,0,96
2013,Septiembre,San Cristóbal y Nevis,3,9,0,12
2013,Septiembre,San  Vicente y las Granadinas,2,4,0,6
2013,Septiembre,Santa Lucia,4,9,0,13
2013,Septiembre,Senegal,3,8,0,11
2013,Septiembre,Serbia,4,3,0,7
2013,Septiembre,Seychelles,1,0,0,1
2013,Septiembre,Singapur,10,27,0,37
2013,Septiembre,República Árabe Siria,1,0,0,1
2013,Septiembre,Sri Lanka,2,2,0,4
2013,Septiembre,Sudáfrica,42,85,0,127
2013,Septiembre,Sudán,1,2,0,3
2013,Septiembre,Suecia,114,212,0,326
2013,Septiembre,Suiza,268,533,0,801
2013,Septiembre,Surinam,26,35,0,61
2013,Septiembre,Taiwán,38,71,0,109
2013,Septiembre,Tailandia,4,8,0,12
2013,Septiembre,Territorio Antártico Británico/Territorio Británico de Ultramar,1,2,0,3
2013,Septiembre,Tanzania,3,6,0,9
2013,Septiembre,Togo,0,4,0,4
2013,Septiembre,Trinidad y Tobago,79,86,0,165
2013,Septiembre,Túnez,1,2,0,3
2013,Septiembre,Turkmenistán,1,0,0,1
2013,Septiembre,Turquía,27,167,0,194
2013,Septiembre,Ucrania,21,73,0,94
2013,Septiembre,Uganda,7,9,0,16
2013,Septiembre,Uruguay,327,543,0,870
2013,Septiembre,Uzbekistán,0,3,0,3
2013,Septiembre,Venezuela,8956,11128,0,20084
2013,Septiembre,Vietnam,6,20,0,26
2013,Septiembre,Islas Vírgenes Británicas/Territorio Británico de Ultramar,1,0,0,1
2013,Septiembre,Yugoslavia,1,0,0,1
2013,Septiembre,Zambia,1,7,0,8
2013,Septiembre,Zimbabue,3,5,0,8
2013,Septiembre,Desconocido,4,24,0,28
2013,Octubre,Afganistán,2,2,0,4
2013,Octubre,Albania,0,2,0,2
2013,Octubre,Alemania,1330,2271,0,3601
2013,Octubre,Andorra,2,17,0,19
2013,Octubre,Angola,3,31,0,34
2013,Octubre,Antigua y Barbuda,2,9,0,11
2013,Octubre,Países Bajos,1072,1700,0,2772
2013,Octubre,Arabia Saudita,0,10,0,10
2013,Octubre,Argelia,0,10,0,10
2013,Octubre,Argentina,4056,5546,0,9602
2013,Octubre,República de Armenia,0,2,0,2
2013,Octubre,Aruba,1,3,0,4
2013,Octubre,Australia,280,510,0,790
2013,Octubre,Austria,94,219,0,313
2013,Octubre,Azerbaiyán,2,4,0,6
2013,Octubre,Bahamas,4,10,0,14
2013,Octubre,Bahréin,0,5,0,5
2013,Octubre,Bangladesh,0,4,0,4
2013,Octubre,Barbados,4,17,0,21
2013,Octubre,República de Belarús,2,5,0,7
2013,Octubre,Bélgica,153,407,0,560
2013,Octubre,Belice,5,15,0,20
2013,Octubre,Benín,2,2,0,4
2013,Octubre,Bermudas/Territorio Británico de Ultramar,1,3,0,4
2013,Octubre,Bolivia,334,524,0,858
2013,Octubre,Bosnia y Herzegovina,2,1,0,3
2013,Octubre,Botsuana,0,5,0,5
2013,Octubre,Brasil,3440,5002,0,8442
2013,Octubre,Brunei Darussalam,0,5,0,5
2013,Octubre,Bulgaria,11,22,0,33
2013,Octubre,Burkina Faso,0,2,0,2
2013,Octubre,Burundi,0,3,0,3
2013,Octubre,Bután,0,2,0,2
2013,Octubre,Cabo Verde,1,0,0,1
2013,Octubre,Islas Caimán/Territorio Británico de Ultramar,2,1,0,3
2013,Octubre,Camboya,0,1,0,1
2013,Octubre,Camerún,4,9,0,13
2013,Octubre,Canadá,757,1562,0,2319
2013,Octubre,Chad,0,1,0,1
2013,Octubre,España,2377,6318,0,8695
2013,Octubre,República Del Congo,0,2,0,2
2013,Octubre,Comoras,0,2,0,2
2013,Octubre,República Democrática del Congo,4,19,0,23
2013,Octubre,República de Corea,147,483,0,630
2013,Octubre,Costa de Marfil,1,6,0,7
2013,Octubre,Costa Rica,619,1093,0,1712
2013,Octubre,Croacia,3,47,0,50
2013,Octubre,Cuba,147,279,0,426
2013,Octubre,Curazao,0,2,0,2
2013,Octubre,República Checa,41,63,0,104
2013,Octubre,Chile,3315,5643,0,8958
2013,Octubre,China,167,498,0,665
2013,Octubre,Chipre,1,4,0,5
2013,Octubre,Dinamarca,51,125,0,176
2013,Octubre,Dominica,2,5,0,7
2013,Octubre,Ecuador,4388,6377,0,10765
2013,Octubre,Egipto,5,16,0,21
2013,Octubre,El Salvador,593,983,0,1576
2013,Octubre,Emiratos Árabes,3,12,0,15
2013,Octubre,Eslovaquia,10,25,0,35
2013,Octubre,Eslovenia,13,23,0,36
2013,Octubre,Estados Unidos de América,7135,15596,0,22731
2013,Octubre,Estonia,4,9,0,13
2013,Octubre,Etiopia,1,12,0,13
2013,Octubre,Islas Fiji,1,6,0,7
2013,Octubre,Filipinas,27,262,0,289
2013,Octubre,Finlandia,36,71,0,107
2013,Octubre,Francia,1005,2078,0,3083
2013,Octubre,Gabón,0,3,0,3
2013,Octubre,Georgia,1,6,0,7
2013,Octubre,Ghana,0,5,0,5
2013,Octubre,Granada,0,1,0,1
2013,Octubre,Grecia,22,71,0,93
2013,Octubre,Guatemala,337,713,0,1050
2013,Octubre,Guyana,5,14,0,19
2013,Octubre,Guinea,0,4,0,4
2013,Octubre,Guinea Ecuatorial,1,0,0,1
2013,Octubre,Guinea Bissau,0,2,0,2
2013,Octubre,Haití,3,37,0,40
2013,Octubre,Honduras,197,344,0,541
2013,Octubre,Hong Kong,0,1,0,1
2013,Octubre,Hungría,20,45,0,65
2013,Octubre,India,44,290,0,334
2013,Octubre,Indonesia,7,57,0,64
2013,Octubre,Iraq,0,9,0,9
2013,Octubre,Irán,3,26,0,29
2013,Octubre,República de Irlanda,63,141,0,204
2013,Octubre,Islandia,5,7,0,12
2013,Octubre,Isla de Man,9,12,0,21
2013,Octubre,Israel,70,499,0,569
2013,Octubre,Italia,507,1919,0,2426
2013,Octubre,Islas del Canal,1,2,0,3
2013,Octubre,Jamaica,15,43,0,58
2013,Octubre,Japón,126,486,0,612
2013,Octubre,Jordania,1,7,0,8
2013,Octubre,Kazajistán,0,1,0,1
2013,Octubre,Kenia,4,14,0,18
2013,Octubre,Kirguistán,2,1,0,3
2013,Octubre,Kuwait,0,10,0,10
2013,Octubre,República de Kosovo,1,0,0,1
2013,Octubre,Lesoto,0,4,0,4
2013,Octubre,Letonia,9,14,0,23
2013,Octubre,Lituania,7,9,0,16
2013,Octubre,Líbano,17,35,0,52
2013,Octubre,Liberia,0,1,0,1
2013,Octubre,Libia,0,1,0,1
2013,Octubre,Liechtenstein,1,3,0,4
2013,Octubre,Luxemburgo,5,17,0,22
2013,Octubre,Macedonia,2,1,0,3
2013,Octubre,Madagascar,2,2,0,4
2013,Octubre,Malasia,12,33,0,45
2013,Octubre,Malawi,2,5,0,7
2013,Octubre,Malí,0,3,0,3
2013,Octubre,Malta,2,8,0,10
2013,Octubre,Marruecos,4,8,0,12
2013,Octubre,Islas Marshall,0,1,0,1
2013,Octubre,Mauritania,0,2,0,2
2013,Octubre,México,2667,6017,0,8684
2013,Octubre,República de Moldavia,2,3,0,5
2013,Octubre,Mónaco,2,3,0,5
2013,Octubre,Mongolia,2,3,0,5
2013,Octubre,Montenegro,0,2,0,2
2013,Octubre,Mozambique,0,8,0,8
2013,Octubre,Myanmar,0,3,0,3
2013,Octubre,Namibia,2,6,0,8
2013,Octubre,Nepal,0,6,0,6
2013,Octubre,Nicaragua,104,149,0,253
2013,Octubre,Nigeria,2,14,0,16
2013,Octubre,Níger,0,3,0,3
2013,Octubre,Noruega,67,139,0,206
2013,Octubre,Nueva Caledonia/Territorio francés,0,1,0,1
2013,Octubre,Nueva Zelanda,44,97,0,141
2013,Octubre,Omán,0,3,0,3
2013,Octubre,Pakistán,0,13,0,13
2013,Octubre,Panamá,984,1756,0,2740
2013,Octubre,Paraguay,116,165,0,281
2013,Octubre,Perú,3861,4860,0,8721
2013,Octubre,Palestina,3,3,0,6
2013,Octubre,Polonia,86,122,0,208
2013,Octubre,Portugal,172,432,0,604
2013,Octubre,Puerto Rico/Territorio de Estados Unidos,0,2,0,2
2013,Octubre,Qatar,0,5,0,5
2013,Octubre,Reino Unido de Gran Bretaña e Irlanda del Norte,613,1532,0,2145
2013,Octubre,República CentroÁfricana,0,1,0,1
2013,Octubre,Federación de Rusia,186,256,0,442
2013,Octubre,República Dominicana,320,464,0,784
2013,Octubre,Rumania,51,101,0,152
2013,Octubre,Rwanda,0,3,0,3
2013,Octubre,Sahara Occidental/Desierto Sahara,0,1,0,1
2013,Octubre,San Cristóbal y Nevis,1,3,0,4
2013,Octubre,Samoa Occidental,1,0,0,1
2013,Octubre,San Marino,1,0,0,1
2013,Octubre,San  Vicente y las Granadinas,1,5,0,6
2013,Octubre,Santa Lucia,4,1,0,5
2013,Octubre,Santa Sede/Ciudad del Vaticano,0,2,0,2
2013,Octubre,Senegal,0,4,0,4
2013,Octubre,Serbia,6,16,0,22
2013,Octubre,Sierra Leona,0,2,0,2
2013,Octubre,Singapur,25,41,0,66
2013,Octubre,República Árabe Siria,0,3,0,3
2013,Octubre,Sri Lanka,3,5,0,8
2013,Octubre,Sudáfrica,32,87,0,119
2013,Octubre,Sudán,0,16,0,16
2013,Octubre,Suecia,140,270,0,410
2013,Octubre,Suiza,372,649,0,1021
2013,Octubre,Surinam,10,29,0,39
2013,Octubre,Suazilandia,1,1,0,2
2013,Octubre,Taiwán,47,84,0,131
2013,Octubre,Tailandia,8,8,0,16
2013,Octubre,Tíbet/Región Autónoma de China,1,0,0,1
2013,Octubre,Territorio Antártico Británico/Territorio Británico de Ultramar,0,2,0,2
2013,Octubre,Tanzania,3,4,0,7
2013,Octubre,Togo,0,1,0,1
2013,Octubre,Trinidad y Tobago,55,103,0,158
2013,Octubre,Túnez,0,2,0,2
2013,Octubre,Turkmenistán,0,3,0,3
2013,Octubre,Turquía,41,108,0,149
2013,Octubre,Ucrania,25,28,0,53
2013,Octubre,Uganda,3,9,0,12
2013,Octubre,Uruguay,291,481,0,772
2013,Octubre,Uzbekistán,1,0,0,1
2013,Octubre,Venezuela,9845,12456,0,22301
2013,Octubre,Vietnam,3,8,0,11
2013,Octubre,República Árabe de Yemen,0,1,0,1
2013,Octubre,Zambia,3,3,0,6
2013,Octubre,Zimbabue,3,5,0,8
2013,Octubre,Islas Turcas y Caicos/Territorio Británico de Ultramar,1,2,0,3
2013,Octubre,Desconocido,46,70,0,116
2013,Noviembre,Afganistán,0,1,0,1
2013,Noviembre,Albania,0,3,0,3
2013,Noviembre,Alemania,1381,2467,0,3848
2013,Noviembre,Andorra,0,8,0,8
2013,Noviembre,Angola,3,1,0,4
2013,Noviembre,Antigua y Barbuda,1,4,0,5
2013,Noviembre,Países Bajos,832,1576,0,2408
2013,Noviembre,Arabia Saudita,0,6,0,6
2013,Noviembre,Argelia,1,4,0,5
2013,Noviembre,Argentina,4520,6416,0,10936
2013,Noviembre,República de Armenia,1,1,0,2
2013,Noviembre,Aruba,0,1,0,1
2013,Noviembre,Australia,412,611,0,1023
2013,Noviembre,Austria,131,256,0,387
2013,Noviembre,Azerbaiyán,0,2,0,2
2013,Noviembre,Bahamas,8,14,0,22
2013,Noviembre,Bahréin,1,1,0,2
2013,Noviembre,Bangladesh,0,1,0,1
2013,Noviembre,Barbados,5,7,0,12
2013,Noviembre,República de Belarús,2,0,0,2
2013,Noviembre,Bélgica,152,416,0,568
2013,Noviembre,Belice,6,19,0,25
2013,Noviembre,Bermudas/Territorio Británico de Ultramar,0,4,0,4
2013,Noviembre,Bolivia,561,805,0,1366
2013,Noviembre,Bosnia y Herzegovina,2,0,0,2
2013,Noviembre,Brasil,3676,5396,0,9072
2013,Noviembre,Bulgaria,15,17,0,32
2013,Noviembre,Burkina Faso,0,2,0,2
2013,Noviembre,Burundi,1,0,0,1
2013,Noviembre,Bután,0,1,0,1
2013,Noviembre,Islas Caimán/Territorio Británico de Ultramar,3,1,0,4
2013,Noviembre,Camboya,0,2,0,2
2013,Noviembre,Antártida,0,1,0,1
2013,Noviembre,Camerún,1,1,0,2
2013,Noviembre,Canadá,1029,2039,0,3068
2013,Noviembre,España,2699,7115,0,9814
2013,Noviembre,República Democrática del Congo,2,1,0,3
2013,Noviembre,República de Corea,175,508,0,683
2013,Noviembre,Costa de Marfil,0,7,0,7
2013,Noviembre,Costa Rica,732,1247,0,1979
2013,Noviembre,Croacia,1,46,0,47
2013,Noviembre,Cuba,130,265,0,395
2013,Noviembre,Curazao,0,1,0,1
2013,Noviembre,República Checa,58,81,0,139
2013,Noviembre,Chile,2684,4158,0,6842
2013,Noviembre,China,207,530,0,737
2013,Noviembre,Chipre,2,4,0,6
2013,Noviembre,Dinamarca,55,140,0,195
2013,Noviembre,Dominica,1,4,0,5
2013,Noviembre,Ecuador,3812,6025,0,9837
2013,Noviembre,Egipto,2,8,0,10
2013,Noviembre,El Salvador,699,1022,0,1721
2013,Noviembre,Emiratos Árabes,0,2,0,2
2013,Noviembre,Eslovaquia,16,33,0,49
2013,Noviembre,Eslovenia,19,39,0,58
2013,Noviembre,Estados Unidos de América,8654,17572,0,26226
2013,Noviembre,Estonia,6,7,0,13
2013,Noviembre,Etiopia,0,3,0,3
2013,Noviembre,Islas Fiji,0,1,0,1
2013,Noviembre,Filipinas,29,180,0,209
2013,Noviembre,Finlandia,59,77,0,136
2013,Noviembre,Francia,969,2079,0,3048
2013,Noviembre,Georgia,1,1,0,2
2013,Noviembre,Ghana,1,7,0,8
2013,Noviembre,Granada,0,1,0,1
2013,Noviembre,Grecia,14,75,0,89
2013,Noviembre,Guatemala,491,921,0,1412
2013,Noviembre,Guyana,6,16,0,22
2013,Noviembre,Guinea,0,1,0,1
2013,Noviembre,Guinea Bissau,0,1,0,1
2013,Noviembre,Haití,11,36,0,47
2013,Noviembre,Honduras,171,309,0,480
2013,Noviembre,Hong Kong,0,1,0,1
2013,Noviembre,Hungría,30,56,0,86
2013,Noviembre,India,39,298,0,337
2013,Noviembre,Indonesia,12,31,0,43
2013,Noviembre,Iraq,1,3,0,4
2013,Noviembre,Irán,6,17,0,23
2013,Noviembre,República de Irlanda,88,176,0,264
2013,Noviembre,Islandia,7,5,0,12
2013,Noviembre,Israel,67,429,0,496
2013,Noviembre,Italia,571,2219,0,2790
2013,Noviembre,Jamaica,17,42,0,59
2013,Noviembre,Japón,126,572,0,698
2013,Noviembre,Jordania,1,7,0,8
2013,Noviembre,Kazajistán,3,6,0,9
2013,Noviembre,Kenia,2,10,0,12
2013,Noviembre,Kirguistán,1,1,0,2
2013,Noviembre,Kuwait,0,2,0,2
2013,Noviembre,Letonia,17,17,0,34
2013,Noviembre,Lituania,27,12,0,39
2013,Noviembre,Líbano,16,35,0,51
2013,Noviembre,Liechtenstein,0,3,0,3
2013,Noviembre,Luxemburgo,7,6,0,13
2013,Noviembre,Madagascar,0,1,0,1
2013,Noviembre,Malasia,18,22,0,40
2013,Noviembre,Malta,1,6,0,7
2013,Noviembre,Marruecos,4,14,0,18
2013,Noviembre,Mauricio,1,1,0,2
2013,Noviembre,Mauritania,0,2,0,2
2013,Noviembre,México,3655,7050,0,10705
2013,Noviembre,República de Moldavia,4,1,0,5
2013,Noviembre,Mónaco,3,1,0,4
2013,Noviembre,Mongolia,0,1,0,1
2013,Noviembre,Mozambique,0,2,0,2
2013,Noviembre,Myanmar,0,1,0,1
2013,Noviembre,Namibia,0,1,0,1
2013,Noviembre,Nepal,0,2,0,2
2013,Noviembre,Nicaragua,103,137,0,240
2013,Noviembre,Nigeria,4,10,0,14
2013,Noviembre,Noruega,64,171,0,235
2013,Noviembre,Nueva Zelanda,64,120,0,184
2013,Noviembre,Pakistán,2,19,0,21
2013,Noviembre,Panamá,1276,1909,0,3185
2013,Noviembre,Paraguay,147,196,0,343
2013,Noviembre,Perú,3210,4807,0,8017
2013,Noviembre,Palestina,0,1,0,1
2013,Noviembre,Polonia,106,160,0,266
2013,Noviembre,Portugal,143,445,0,588
2013,Noviembre,Puerto Rico/Territorio de Estados Unidos,1,0,0,1
2013,Noviembre,Qatar,0,1,0,1
2013,Noviembre,Reino Unido de Gran Bretaña e Irlanda del Norte,738,1650,0,2388
2013,Noviembre,República CentroÁfricana,0,1,0,1
2013,Noviembre,Federación de Rusia,206,292,0,498
2013,Noviembre,República Dominicana,326,650,0,976
2013,Noviembre,República Democrática Popular de Corea,0,1,0,1
2013,Noviembre,Rumania,39,79,0,118
2013,Noviembre,San Cristóbal y Nevis,1,0,0,1
2013,Noviembre,Samoa Occidental,1,0,0,1
2013,Noviembre,San Marino,0,1,0,1
2013,Noviembre,San  Vicente y las Granadinas,1,2,0,3
2013,Noviembre,Santa Lucia,4,2,0,6
2013,Noviembre,Senegal,0,2,0,2
2013,Noviembre,Serbia,3,13,0,16
2013,Noviembre,Singapur,13,16,0,29
2013,Noviembre,República Árabe Siria,0,1,0,1
2013,Noviembre,Sri Lanka,0,1,0,1
2013,Noviembre,Sudáfrica,59,140,0,199
2013,Noviembre,Sudán,0,1,0,1
2013,Noviembre,Suecia,201,335,0,536
2013,Noviembre,Suiza,356,646,0,1002
2013,Noviembre,Surinam,22,33,0,55
2013,Noviembre,Taiwán,51,103,0,154
2013,Noviembre,Tailandia,11,7,0,18
2013,Noviembre,Tanzania,0,1,0,1
2013,Noviembre,Togo,0,1,0,1
2013,Noviembre,Trinidad y Tobago,25,73,0,98
2013,Noviembre,Túnez,1,3,0,4
2013,Noviembre,Turquía,28,148,0,176
2013,Noviembre,Ucrania,19,57,0,76
2013,Noviembre,Uganda,0,2,0,2
2013,Noviembre,Uruguay,357,514,0,871
2013,Noviembre,Venezuela,9981,12858,0,22839
2013,Noviembre,Vietnam,3,4,0,7
2013,Noviembre,República Árabe de Yemen,0,1,0,1
2013,Noviembre,Zimbabue,1,2,0,3
2013,Noviembre,Desconocido,48,83,0,131
2013,Diciembre,Albania,0,5,0,5
2013,Diciembre,Alemania,1587,2528,0,4115
2013,Diciembre,Andorra,0,4,0,4
2013,Diciembre,Angola,1,0,0,1
2013,Diciembre,Antigua y Barbuda,0,7,0,7
2013,Diciembre,Países Bajos,1044,1913,0,2957
2013,Diciembre,Arabia Saudita,2,26,0,28
2013,Diciembre,Argelia,3,4,0,7
2013,Diciembre,Argentina,3726,4925,0,8651
2013,Diciembre,República de Armenia,0,1,0,1
2013,Diciembre,Australia,496,875,0,1371
2013,Diciembre,Austria,139,284,0,423
2013,Diciembre,Azerbaiyán,3,0,0,3
2013,Diciembre,Bahamas,0,5,0,5
2013,Diciembre,Bahréin,3,1,0,4
2013,Diciembre,Bangladesh,0,3,0,3
2013,Diciembre,Barbados,13,6,0,19
2013,Diciembre,República de Belarús,3,2,0,5
2013,Diciembre,Bélgica,169,456,0,625
2013,Diciembre,Belice,11,15,0,26
2013,Diciembre,Benín,3,1,0,4
2013,Diciembre,Bermudas/Territorio Británico de Ultramar,0,2,0,2
2013,Diciembre,Bolivia,616,581,0,1197
2013,Diciembre,Bosnia y Herzegovina,0,1,0,1
2013,Diciembre,Brasil,3902,4737,0,8639
2013,Diciembre,Bulgaria,17,21,0,38
2013,Diciembre,Burkina Faso,0,1,0,1
2013,Diciembre,Burundi,0,1,0,1
2013,Diciembre,Cabo Verde,0,1,0,1
2013,Diciembre,Islas Caimán/Territorio Británico de Ultramar,4,10,0,14
2013,Diciembre,Camboya,0,1,0,1
2013,Diciembre,Camerún,0,1,0,1
2013,Diciembre,Canadá,2338,3433,0,5771
2013,Diciembre,España,2862,6117,0,8979
2013,Diciembre,República Democrática del Congo,4,5,0,9
2013,Diciembre,República de Corea,189,358,0,547
2013,Diciembre,Costa de Marfil,1,0,0,1
2013,Diciembre,Costa Rica,1325,1631,0,2956
2013,Diciembre,Croacia,8,38,0,46
2013,Diciembre,Cuba,137,282,0,419
2013,Diciembre,Curazao,3,4,0,7
2013,Diciembre,República Checa,43,55,0,98
2013,Diciembre,Chile,1971,3160,0,5131
2013,Diciembre,China,147,409,0,556
2013,Diciembre,Chipre,1,11,0,12
2013,Diciembre,Dinamarca,102,189,0,291
2013,Diciembre,Dominica,0,3,0,3
2013,Diciembre,Ecuador,4850,6894,0,11744
2013,Diciembre,Egipto,2,13,0,15
2013,Diciembre,El Salvador,532,789,0,1321
2013,Diciembre,Emiratos Árabes,4,5,0,9
2013,Diciembre,Eslovaquia,12,14,0,26
2013,Diciembre,Eslovenia,21,36,0,57
2013,Diciembre,Estados Unidos de América,15204,25484,0,40688
2013,Diciembre,Estonia,7,12,0,19
2013,Diciembre,Filipinas,25,161,0,186
2013,Diciembre,Finlandia,75,114,0,189
2013,Diciembre,Francia,1523,2691,0,4214
2013,Diciembre,Gabón,0,1,0,1
2013,Diciembre,Georgia,2,2,0,4
2013,Diciembre,Ghana,2,0,0,2
2013,Diciembre,Granada,0,4,0,4
2013,Diciembre,Grecia,38,84,0,122
2013,Diciembre,Guatemala,439,780,0,1219
2013,Diciembre,Guyana,13,19,0,32
2013,Diciembre,Guinea Ecuatorial,0,2,0,2
2013,Diciembre,Haití,17,38,0,55
2013,Diciembre,Honduras,230,298,0,528
2013,Diciembre,Hungría,34,40,0,74
2013,Diciembre,India,63,253,0,316
2013,Diciembre,Indonesia,13,38,0,51
2013,Diciembre,Iraq,0,2,0,2
2013,Diciembre,Irán,1,16,0,17
2013,Diciembre,República de Irlanda,87,174,0,261
2013,Diciembre,Islandia,12,17,0,29
2013,Diciembre,Israel,71,438,0,509
2013,Diciembre,Italia,706,2129,0,2835
2013,Diciembre,Jamaica,11,24,0,35
2013,Diciembre,Japón,178,451,0,629
2013,Diciembre,Jordania,2,6,0,8
2013,Diciembre,Kazajistán,4,1,0,5
2013,Diciembre,Kenia,8,13,0,21
2013,Diciembre,Kirguistán,0,1,0,1
2013,Diciembre,Kuwait,2,15,0,17
2013,Diciembre,República de Kosovo,2,1,0,3
2013,Diciembre,República Democrática Popular  Lao,1,0,0,1
2013,Diciembre,Letonia,7,5,0,12
2013,Diciembre,Lituania,22,22,0,44
2013,Diciembre,Líbano,15,27,0,42
2013,Diciembre,Liberia,1,2,0,3
2013,Diciembre,Libia,0,2,0,2
2013,Diciembre,Liechtenstein,1,6,0,7
2013,Diciembre,Luxemburgo,5,9,0,14
2013,Diciembre,Macedonia,0,2,0,2
2013,Diciembre,Malasia,22,29,0,51
2013,Diciembre,Malta,4,6,0,10
2013,Diciembre,Marruecos,9,9,0,18
2013,Diciembre,Mauricio,0,2,0,2
2013,Diciembre,Mauritania,0,4,0,4
2013,Diciembre,México,3321,5897,0,9218
2013,Diciembre,República de Moldavia,2,0,0,2
2013,Diciembre,Mónaco,3,2,0,5
2013,Diciembre,Mongolia,0,1,0,1
2013,Diciembre,Montenegro,2,5,0,7
2013,Diciembre,Mozambique,3,1,0,4
2013,Diciembre,Myanmar,0,53,0,53
2013,Diciembre,Nepal,0,4,0,4
2013,Diciembre,Nicaragua,62,104,0,166
2013,Diciembre,Nigeria,4,11,0,15
2013,Diciembre,Noruega,186,264,0,450
2013,Diciembre,Nueva Zelanda,75,125,0,200
2013,Diciembre,Pakistán,2,11,0,13
2013,Diciembre,Panamá,1311,2071,0,3382
2013,Diciembre,Paraguay,122,107,0,229
2013,Diciembre,Perú,3003,4232,0,7235
2013,Diciembre,Palestina,0,1,0,1
2013,Diciembre,Polonia,88,168,0,256
2013,Diciembre,Portugal,126,402,0,528
2013,Diciembre,Puerto Rico/Territorio de Estados Unidos,2,1,0,3
2013,Diciembre,Qatar,0,4,0,4
2013,Diciembre,Reino Unido de Gran Bretaña e Irlanda del Norte,948,2043,0,2991
2013,Diciembre,República CentroÁfricana,0,1,0,1
2013,Diciembre,Federación de Rusia,167,216,0,383
2013,Diciembre,República Dominicana,323,482,0,805
2013,Diciembre,Rumania,57,96,0,153
2013,Diciembre,Rwanda,0,1,0,1
2013,Diciembre,San Cristóbal y Nevis,1,1,0,2
2013,Diciembre,Santa Lucia,3,8,0,11
2013,Diciembre,Santa Sede/Ciudad del Vaticano,0,1,0,1
2013,Diciembre,Senegal,0,2,0,2
2013,Diciembre,Serbia,11,5,0,16
2013,Diciembre,Singapur,15,32,0,47
2013,Diciembre,República Árabe Siria,1,3,0,4
2013,Diciembre,Somalia,1,0,0,1
2013,Diciembre,Sri Lanka,1,5,0,6
2013,Diciembre,Sudáfrica,42,59,0,101
2013,Diciembre,Sudán,0,2,0,2
2013,Diciembre,Suecia,389,610,0,999
2013,Diciembre,Suiza,522,960,0,1482
2013,Diciembre,Surinam,43,43,0,86
2013,Diciembre,Taiwán,51,62,0,113
2013,Diciembre,Tailandia,7,5,0,12
2013,Diciembre,Tanzania,3,0,0,3
2013,Diciembre,Tonga,0,5,0,5
2013,Diciembre,Trinidad y Tobago,33,82,0,115
2013,Diciembre,Túnez,0,2,0,2
2013,Diciembre,Turkmenistán,1,0,0,1
2013,Diciembre,Turquía,24,79,0,103
2013,Diciembre,Tuvalu,0,4,0,4
2013,Diciembre,Ucrania,21,46,0,67
2013,Diciembre,Uganda,4,8,0,12
2013,Diciembre,Uruguay,222,383,0,605
2013,Diciembre,Uzbekistán,1,1,0,2
2013,Diciembre,Venezuela,14365,17166,0,31531
2013,Diciembre,Vietnam,2,1,0,3
2013,Diciembre,República Árabe de Yemen,0,1,0,1
2013,Diciembre,Zambia,0,2,0,2
2013,Diciembre,Zimbabue,1,1,0,2
2013,Diciembre,Anguila/Territorio Británico de Ultramar,0,1,0,1
2013,Diciembre,Desconocido,31,87,0,118
2014,Enero,Albania,2,4,0,6
2014,Enero,Alemania,1671,2469,0,4140
2014,Enero,Andorra,1,8,0,9
2014,Enero,Angola,0,1,0,1
2014,Enero,Antigua y Barbuda,0,2,0,2
2014,Enero,Países Bajos,942,1601,0,2543
2014,Enero,Arabia Saudita,0,7,0,7
2014,Enero,Argelia,1,6,0,7
2014,Enero,Argentina,7105,7129,0,14234
2014,Enero,República de Armenia,2,0,0,2
2014,Enero,Aruba,0,1,0,1
2014,Enero,Australia,381,624,0,1005
2014,Enero,Austria,152,285,0,437
2014,Enero,Bahamas,5,10,0,15
2014,Enero,Bahréin,0,1,0,1
2014,Enero,Bangladesh,0,4,0,4
2014,Enero,Barbados,12,5,0,17
2014,Enero,República de Belarús,5,2,0,7
2014,Enero,Bélgica,199,419,0,618
2014,Enero,Belice,3,3,0,6
2014,Enero,Benín,1,0,0,1
2014,Enero,Bermudas/Territorio Británico de Ultramar,0,1,0,1
2014,Enero,Bolivia,651,778,0,1429
2014,Enero,Bosnia y Herzegovina,1,1,0,2
2014,Enero,Brasil,4639,5423,0,10062
2014,Enero,Bulgaria,20,13,0,33
2014,Enero,Burkina Faso,1,0,0,1
2014,Enero,Burundi,0,7,0,7
2014,Enero,Cabo Verde,0,1,0,1
2014,Enero,Islas Caimán/Territorio Británico de Ultramar,3,1,0,4
2014,Enero,Canadá,2372,3208,0,5580
2014,Enero,Chad,0,1,0,1
2014,Enero,España,2690,6398,0,9088
2014,Enero,República Democrática del Congo,4,11,0,15
2014,Enero,República de Corea,246,426,0,672
2014,Enero,Costa de Marfil,0,2,0,2
2014,Enero,Costa Rica,1308,1406,0,2714
2014,Enero,Croacia,10,48,0,58
2014,Enero,Cuba,157,267,0,424
2014,Enero,República Checa,40,86,0,126
2014,Enero,Chile,3423,3972,0,7395
2014,Enero,China,148,292,0,440
2014,Enero,Chipre,2,5,0,7
2014,Enero,Dinamarca,101,182,0,283
2014,Enero,Dominica,2,4,0,6
2014,Enero,Ecuador,3356,5351,0,8707
2014,Enero,Egipto,4,13,0,17
2014,Enero,El Salvador,548,834,0,1382
2014,Enero,Emiratos Árabes,0,1,0,1
2014,Enero,Eslovaquia,15,34,0,49
2014,Enero,Eslovenia,27,30,0,57
2014,Enero,Estados Unidos de América,8359,16436,0,24795
2014,Enero,Estonia,10,10,0,20
2014,Enero,Etiopia,0,1,0,1
2014,Enero,Filipinas,26,125,0,151
2014,Enero,Finlandia,68,101,0,169
2014,Enero,Francia,1641,2517,0,4158
2014,Enero,Georgia,3,1,0,4
2014,Enero,Ghana,1,2,0,3
2014,Enero,Granada,0,1,0,1
2014,Enero,Grecia,22,91,0,113
2014,Enero,Guatemala,320,663,0,983
2014,Enero,Guyana,7,14,0,21
2014,Enero,Guinea Ecuatorial,1,0,0,1
2014,Enero,Haití,16,19,0,35
2014,Enero,Honduras,172,285,0,457
2014,Enero,Hong Kong,0,1,0,1
2014,Enero,Hungría,30,50,0,80
2014,Enero,India,62,300,0,362
2014,Enero,Indonesia,5,20,0,25
2014,Enero,Irán,4,8,0,12
2014,Enero,República de Irlanda,76,191,0,267
2014,Enero,Islandia,10,10,0,20
2014,Enero,Israel,80,493,0,573
2014,Enero,Italia,754,2334,0,3088
2014,Enero,Jamaica,18,31,0,49
2014,Enero,Islas Salomón,1,0,0,1
2014,Enero,Japón,155,477,0,632
2014,Enero,Jordania,0,4,0,4
2014,Enero,Kazajistán,0,2,0,2
2014,Enero,Kenia,1,2,0,3
2014,Enero,Kuwait,0,2,0,2
2014,Enero,República de Kosovo,1,1,0,2
2014,Enero,Letonia,12,30,0,42
2014,Enero,Lituania,15,11,0,26
2014,Enero,Líbano,12,24,0,36
2014,Enero,Liechtenstein,1,1,0,2
2014,Enero,Luxemburgo,3,13,0,16
2014,Enero,Macedonia,2,0,0,2
2014,Enero,Madagascar,3,1,0,4
2014,Enero,Malasia,9,11,0,20
2014,Enero,Malí,0,1,0,1
2014,Enero,Malta,5,10,0,15
2014,Enero,Marruecos,4,15,0,19
2014,Enero,Mauricio,0,1,0,1
2014,Enero,México,2715,5442,0,8157
2014,Enero,República de Moldavia,4,3,0,7
2014,Enero,Mónaco,1,1,0,2
2014,Enero,Mongolia,1,0,0,1
2014,Enero,Montenegro,1,4,0,5
2014,Enero,Nepal,0,1,0,1
2014,Enero,Nicaragua,95,122,0,217
2014,Enero,Nigeria,0,8,0,8
2014,Enero,Noruega,124,206,0,330
2014,Enero,Nueva Zelanda,62,87,0,149
2014,Enero,Pakistán,3,21,0,24
2014,Enero,Panamá,1157,1611,0,2768
2014,Enero,Paraguay,142,151,0,293
2014,Enero,Perú,3769,4807,0,8576
2014,Enero,Palestina,1,5,0,6
2014,Enero,Polonia,159,192,0,351
2014,Enero,Portugal,182,481,0,663
2014,Enero,Qatar,0,2,0,2
2014,Enero,Reino Unido de Gran Bretaña e Irlanda del Norte,814,1819,0,2633
2014,Enero,República CentroÁfricana,5,0,0,5
2014,Enero,Federación de Rusia,400,497,0,897
2014,Enero,República Dominicana,280,570,0,850
2014,Enero,República Democrática Popular de Corea,0,1,0,1
2014,Enero,Rumania,58,82,0,140
2014,Enero,Rwanda,1,1,0,2
2014,Enero,San Cristóbal y Nevis,1,2,0,3
2014,Enero,Samoa Estadounidense/Territorio no incorporado de Estados Unidos,0,1,0,1
2014,Enero,San Marino,0,1,0,1
2014,Enero,San  Vicente y las Granadinas,1,2,0,3
2014,Enero,Santa Lucia,1,1,0,2
2014,Enero,Santa Sede/Ciudad del Vaticano,0,2,0,2
2014,Enero,Senegal,1,0,0,1
2014,Enero,Serbia,10,11,0,21
2014,Enero,Singapur,11,22,0,33
2014,Enero,República Árabe Siria,1,3,0,4
2014,Enero,Somalia,1,1,0,2
2014,Enero,Sri Lanka,1,3,0,4
2014,Enero,Sudáfrica,31,66,0,97
2014,Enero,Suecia,279,446,0,725
2014,Enero,Suiza,413,729,0,1142
2014,Enero,Surinam,29,29,0,58
2014,Enero,Taiwán,38,58,0,96
2014,Enero,Tailandia,1,3,0,4
2014,Enero,Tanzania,3,3,0,6
2014,Enero,Togo,0,3,0,3
2014,Enero,Trinidad y Tobago,24,58,0,82
2014,Enero,Túnez,1,1,0,2
2014,Enero,Turquía,42,134,0,176
2014,Enero,Ucrania,33,40,0,73
2014,Enero,Uganda,1,0,0,1
2014,Enero,Uruguay,262,413,0,675
2014,Enero,Uzbekistán,1,0,0,1
2014,Enero,Venezuela,11261,13401,0,24662
2014,Enero,Vietnam,2,2,0,4
2014,Enero,Zambia,0,1,0,1
2014,Enero,Zimbabue,3,1,0,4
2014,Enero,Desconocido,36,50,0,86
2014,Febrero,Afganistán,0,2,0,2
2014,Febrero,Albania,1,7,0,8
2014,Febrero,Alemania,1784,2712,0,4496
2014,Febrero,Andorra,8,9,0,17
2014,Febrero,Antigua y Barbuda,1,2,0,3
2014,Febrero,Países Bajos,979,1572,0,2551
2014,Febrero,Arabia Saudita,1,1,0,2
2014,Febrero,Argelia,2,3,0,5
2014,Febrero,Argentina,5134,6170,0,11304
2014,Febrero,República de Armenia,0,1,0,1
2014,Febrero,Aruba,0,1,0,1
2014,Febrero,Australia,273,571,0,844
2014,Febrero,Austria,175,296,0,471
2014,Febrero,Azerbaiyán,1,0,0,1
2014,Febrero,Bahamas,3,12,0,15
2014,Febrero,Bahréin,0,1,0,1
2014,Febrero,Bangladesh,1,5,0,6
2014,Febrero,Barbados,4,7,0,11
2014,Febrero,República de Belarús,9,20,0,29
2014,Febrero,Bélgica,169,419,0,588
2014,Febrero,Belice,2,8,0,10
2014,Febrero,Benín,1,1,0,2
2014,Febrero,Bermudas/Territorio Británico de Ultramar,1,3,0,4
2014,Febrero,Bolivia,310,473,0,783
2014,Febrero,Bosnia y Herzegovina,0,1,0,1
2014,Febrero,Botsuana,1,0,0,1
2014,Febrero,Brasil,3901,5026,0,8927
2014,Febrero,Bulgaria,33,22,0,55
2014,Febrero,Islas Caimán/Territorio Británico de Ultramar,2,4,0,6
2014,Febrero,Camboya,0,5,0,5
2014,Febrero,Canadá,2227,3129,0,5356
2014,Febrero,España,2206,5604,0,7810
2014,Febrero,República Democrática del Congo,2,0,0,2
2014,Febrero,República de Corea,214,511,0,725
2014,Febrero,Costa de Marfil,0,2,0,2
2014,Febrero,Costa Rica,765,1104,0,1869
2014,Febrero,Croacia,12,49,0,61
2014,Febrero,Cuba,101,204,0,305
2014,Febrero,Curazao,1,0,0,1
2014,Febrero,República Checa,68,94,0,162
2014,Febrero,Chile,5146,5485,0,10631
2014,Febrero,China,190,495,0,685
2014,Febrero,Chipre,2,4,0,6
2014,Febrero,Dinamarca,101,237,0,338
2014,Febrero,Dominica,1,2,0,3
2014,Febrero,Ecuador,4038,5324,0,9362
2014,Febrero,Egipto,6,24,0,30
2014,Febrero,El Salvador,561,909,0,1470
2014,Febrero,Emiratos Árabes,1,6,0,7
2014,Febrero,Eslovaquia,19,22,0,41
2014,Febrero,Eslovenia,23,34,0,57
2014,Febrero,Estados Unidos de América,9764,18848,0,28612
2014,Febrero,Estonia,6,14,0,20
2014,Febrero,Etiopia,0,4,0,4
2014,Febrero,Filipinas,25,172,0,197
2014,Febrero,Finlandia,76,116,0,192
2014,Febrero,Francia,1385,2507,0,3892
2014,Febrero,Gabón,0,1,0,1
2014,Febrero,Georgia,2,2,0,4
2014,Febrero,Ghana,5,3,0,8
2014,Febrero,Granada,1,0,0,1
2014,Febrero,Grecia,25,94,0,119
2014,Febrero,Guatemala,341,715,0,1056
2014,Febrero,Guyana,2,9,0,11
2014,Febrero,Guinea,0,2,0,2
2014,Febrero,Guinea Bissau,0,1,0,1
2014,Febrero,Guayana Francesa/Departamento de Ultramar Francés,1,0,0,1
2014,Febrero,Haití,4,21,0,25
2014,Febrero,Honduras,151,249,0,400
2014,Febrero,Hungría,26,59,0,85
2014,Febrero,India,59,312,0,371
2014,Febrero,Indonesia,19,35,0,54
2014,Febrero,Iraq,0,1,0,1
2014,Febrero,Irán,3,11,0,14
2014,Febrero,República de Irlanda,61,177,0,238
2014,Febrero,Islandia,6,5,0,11
2014,Febrero,Israel,86,547,0,633
2014,Febrero,Italia,617,2099,0,2716
2014,Febrero,Jamaica,14,25,0,39
2014,Febrero,Japón,150,616,0,766
2014,Febrero,Jordania,3,3,0,6
2014,Febrero,Kazajistán,0,7,0,7
2014,Febrero,Kenia,2,5,0,7
2014,Febrero,Kirguistán,0,1,0,1
2014,Febrero,República de Kosovo,1,0,0,1
2014,Febrero,República Democrática Popular  Lao,3,1,0,4
2014,Febrero,Letonia,10,45,0,55
2014,Febrero,Lituania,15,18,0,33
2014,Febrero,Líbano,17,32,0,49
2014,Febrero,Liechtenstein,2,1,0,3
2014,Febrero,Luxemburgo,4,12,0,16
2014,Febrero,Macedonia,1,3,0,4
2014,Febrero,Malasia,16,32,0,48
2014,Febrero,Malawi,0,1,0,1
2014,Febrero,Malí,0,2,0,2
2014,Febrero,Malta,2,10,0,12
2014,Febrero,Marruecos,4,15,0,19
2014,Febrero,Mauricio,0,1,0,1
2014,Febrero,Mauritania,1,1,0,2
2014,Febrero,México,2399,5685,0,8084
2014,Febrero,República de Moldavia,2,1,0,3
2014,Febrero,Mónaco,0,1,0,1
2014,Febrero,Mongolia,1,1,0,2
2014,Febrero,Montenegro,0,2,0,2
2014,Febrero,Myanmar,2,17,0,19
2014,Febrero,Nepal,1,7,0,8
2014,Febrero,Nicaragua,73,101,0,174
2014,Febrero,Nigeria,2,11,0,13
2014,Febrero,Noruega,120,191,0,311
2014,Febrero,Nueva Zelanda,42,94,0,136
2014,Febrero,Omán,1,1,0,2
2014,Febrero,Pakistán,1,10,0,11
2014,Febrero,Panamá,1044,1678,0,2722
2014,Febrero,Paraguay,142,200,0,342
2014,Febrero,Perú,4867,5473,0,10340
2014,Febrero,Polonia,186,215,0,401
2014,Febrero,Portugal,95,378,0,473
2014,Febrero,Puerto Rico/Territorio de Estados Unidos,0,1,0,1
2014,Febrero,Reino Unido de Gran Bretaña e Irlanda del Norte,859,1760,0,2619
2014,Febrero,Federación de Rusia,246,277,0,523
2014,Febrero,República Dominicana,335,608,0,943
2014,Febrero,Rumania,36,60,0,96
2014,Febrero,San Cristóbal y Nevis,0,5,0,5
2014,Febrero,San  Vicente y las Granadinas,1,4,0,5
2014,Febrero,Santa Lucia,7,1,0,8
2014,Febrero,Senegal,0,1,0,1
2014,Febrero,Serbia,3,10,0,13
2014,Febrero,Singapur,12,18,0,30
2014,Febrero,República Árabe Siria,0,1,0,1
2014,Febrero,Sri Lanka,0,2,0,2
2014,Febrero,Sudáfrica,29,74,0,103
2014,Febrero,Sudán,0,1,0,1
2014,Febrero,Suecia,256,373,0,629
2014,Febrero,Suiza,439,758,0,1197
2014,Febrero,Surinam,13,22,0,35
2014,Febrero,Taiwán,80,102,0,182
2014,Febrero,República de Tayikistán,1,0,0,1
2014,Febrero,Tailandia,15,8,0,23
2014,Febrero,Tanzania,0,1,0,1
2014,Febrero,Togo,0,4,0,4
2014,Febrero,Trinidad y Tobago,40,81,0,121
2014,Febrero,Túnez,2,6,0,8
2014,Febrero,Turkmenistán,1,0,0,1
2014,Febrero,Turquía,36,123,0,159
2014,Febrero,Ucrania,13,45,0,58
2014,Febrero,Uganda,0,3,0,3
2014,Febrero,Uruguay,323,504,0,827
2014,Febrero,Uzbekistán,2,0,0,2
2014,Febrero,Venezuela,7350,9848,0,17198
2014,Febrero,Vietnam,6,14,0,20
2014,Febrero,República Árabe de Yemen,0,1,0,1
2014,Febrero,Zambia,0,1,0,1
2014,Febrero,Zimbabue,3,0,0,3
2014,Febrero,Desconocido,43,70,0,113
2014,Marzo,Afganistán,1,4,0,5
2014,Marzo,Albania,2,3,0,5
2014,Marzo,Alemania,1677,2793,0,4470
2014,Marzo,Andorra,0,8,0,8
2014,Marzo,Angola,0,5,0,5
2014,Marzo,Antigua y Barbuda,1,3,0,4
2014,Marzo,Países Bajos,945,1674,0,2619
2014,Marzo,Arabia Saudita,4,12,0,16
2014,Marzo,Argelia,3,8,0,11
2014,Marzo,Argentina,6130,7178,0,13308
2014,Marzo,República de Armenia,2,2,0,4
2014,Marzo,Aruba,0,1,0,1
2014,Marzo,Australia,309,554,0,863
2014,Marzo,Austria,114,276,0,390
2014,Marzo,Azerbaiyán,2,5,0,7
2014,Marzo,Bahamas,2,9,0,11
2014,Marzo,Bahréin,0,1,0,1
2014,Marzo,Bangladesh,2,3,0,5
2014,Marzo,Barbados,11,6,0,17
2014,Marzo,República de Belarús,1,3,0,4
2014,Marzo,Bélgica,173,369,0,542
2014,Marzo,Belice,2,9,0,11
2014,Marzo,Benín,1,6,0,7
2014,Marzo,Bermudas/Territorio Británico de Ultramar,0,2,0,2
2014,Marzo,Bolivia,324,533,0,857
2014,Marzo,Bosnia y Herzegovina,1,0,0,1
2014,Marzo,Botsuana,1,0,0,1
2014,Marzo,Brasil,4242,5914,0,10156
2014,Marzo,Bulgaria,24,18,0,42
2014,Marzo,Burundi,0,1,0,1
2014,Marzo,Cabo Verde,0,5,0,5
2014,Marzo,Islas Caimán/Territorio Británico de Ultramar,0,3,0,3
2014,Marzo,Camerún,0,2,0,2
2014,Marzo,Canadá,1949,2785,0,4734
2014,Marzo,España,2304,6313,0,8617
2014,Marzo,República Del Congo,0,1,0,1
2014,Marzo,República Democrática del Congo,3,0,0,3
2014,Marzo,República de Corea,176,519,0,695
2014,Marzo,Costa de Marfil,1,2,0,3
2014,Marzo,Costa Rica,669,1148,0,1817
2014,Marzo,Croacia,11,55,0,66
2014,Marzo,Cuba,123,244,0,367
2014,Marzo,República Checa,56,87,0,143
2014,Marzo,Chile,4163,5317,0,9480
2014,Marzo,China,186,572,0,758
2014,Marzo,Chipre,4,5,0,9
2014,Marzo,Dinamarca,72,195,0,267
2014,Marzo,Dominica,3,4,0,7
2014,Marzo,Ecuador,4479,6520,0,10999
2014,Marzo,Egipto,5,16,0,21
2014,Marzo,El Salvador,557,848,0,1405
2014,Marzo,Emiratos Árabes,3,3,0,6
2014,Marzo,Eslovaquia,19,26,0,45
2014,Marzo,Eslovenia,6,31,0,37
2014,Marzo,Estados Unidos de América,10753,20092,0,30845
2014,Marzo,Estonia,10,14,0,24
2014,Marzo,Etiopia,0,2,0,2
2014,Marzo,Filipinas,24,148,0,172
2014,Marzo,Finlandia,47,103,0,150
2014,Marzo,Francia,1216,2304,0,3520
2014,Marzo,Georgia,1,2,0,3
2014,Marzo,Ghana,0,2,0,2
2014,Marzo,Grecia,23,86,0,109
2014,Marzo,Guatemala,331,766,0,1097
2014,Marzo,Guyana,5,13,0,18
2014,Marzo,Guinea,0,1,0,1
2014,Marzo,Guinea Bissau,1,3,0,4
2014,Marzo,Haití,27,23,0,50
2014,Marzo,Honduras,183,308,0,491
2014,Marzo,Hungría,26,55,0,81
2014,Marzo,India,66,366,0,432
2014,Marzo,Indonesia,9,20,0,29
2014,Marzo,Irán,6,17,0,23
2014,Marzo,República de Irlanda,77,175,0,252
2014,Marzo,Islandia,1,13,0,14
2014,Marzo,Israel,122,721,0,843
2014,Marzo,Italia,540,2039,0,2579
2014,Marzo,Jamaica,31,38,0,69
2014,Marzo,Japón,172,552,0,724
2014,Marzo,Jordania,0,2,0,2
2014,Marzo,Kazajistán,4,1,0,5
2014,Marzo,Kenia,4,9,0,13
2014,Marzo,Kirguistán,0,1,0,1
2014,Marzo,Kuwait,0,1,0,1
2014,Marzo,República de Kosovo,1,1,0,2
2014,Marzo,Letonia,12,9,0,21
2014,Marzo,Lituania,16,28,0,44
2014,Marzo,Líbano,17,23,0,40
2014,Marzo,Liberia,0,3,0,3
2014,Marzo,Liechtenstein,1,1,0,2
2014,Marzo,Luxemburgo,2,8,0,10
2014,Marzo,Macedonia,0,4,0,4
2014,Marzo,Madagascar,3,0,0,3
2014,Marzo,Malasia,13,30,0,43
2014,Marzo,Malí,1,2,0,3
2014,Marzo,Malta,2,4,0,6
2014,Marzo,Marruecos,1,7,0,8
2014,Marzo,México,2547,6322,0,8869
2014,Marzo,República de Moldavia,3,3,0,6
2014,Marzo,Mónaco,1,2,0,3
2014,Marzo,Mongolia,1,0,0,1
2014,Marzo,Montenegro,0,2,0,2
2014,Marzo,Namibia,1,0,0,1
2014,Marzo,Nepal,1,2,0,3
2014,Marzo,Nicaragua,79,109,0,188
2014,Marzo,Nigeria,6,16,0,22
2014,Marzo,Noruega,74,147,0,221
2014,Marzo,Nueva Zelanda,59,122,0,181
2014,Marzo,Omán,1,1,0,2
2014,Marzo,Pakistán,3,8,0,11
2014,Marzo,Panamá,1055,1602,0,2657
2014,Marzo,Paraguay,179,197,0,376
2014,Marzo,Perú,4558,5698,0,10256
2014,Marzo,Polonia,116,151,0,267
2014,Marzo,Portugal,140,409,0,549
2014,Marzo,Reino Unido de Gran Bretaña e Irlanda del Norte,768,1779,0,2547
2014,Marzo,Federación de Rusia,228,275,0,503
2014,Marzo,República Dominicana,342,596,0,938
2014,Marzo,Rumania,41,75,0,116
2014,Marzo,San Cristóbal y Nevis,2,1,0,3
2014,Marzo,San  Vicente y las Granadinas,1,1,0,2
2014,Marzo,Santa Lucia,1,3,0,4
2014,Marzo,Senegal,0,2,0,2
2014,Marzo,Serbia,4,22,0,26
2014,Marzo,Singapur,6,28,0,34
2014,Marzo,República Árabe Siria,0,4,0,4
2014,Marzo,Sri Lanka,1,1,0,2
2014,Marzo,Sudáfrica,29,91,0,120
2014,Marzo,Suecia,197,307,0,504
2014,Marzo,Suiza,340,678,0,1018
2014,Marzo,Surinam,22,55,0,77
2014,Marzo,Taiwán,73,121,0,194
2014,Marzo,Tailandia,6,4,0,10
2014,Marzo,Tanzania,2,0,0,2
2014,Marzo,Trinidad y Tobago,21,71,0,92
2014,Marzo,Túnez,0,2,0,2
2014,Marzo,Turquía,34,158,0,192
2014,Marzo,Ucrania,16,48,0,64
2014,Marzo,Uganda,1,3,0,4
2014,Marzo,Uruguay,385,539,0,924
2014,Marzo,Uzbekistán,2,0,0,2
2014,Marzo,Venezuela,6204,9247,0,15451
2014,Marzo,Vietnam,1,3,0,4
2014,Marzo,República Árabe de Yemen,0,1,0,1
2014,Marzo,Zambia,0,1,0,1
2014,Marzo,Desconocido,63,102,0,165
2014,Abril,Afganistán,1,7,0,8
2014,Abril,Albania,2,2,0,4
2014,Abril,Alemania,1595,2319,0,3914
2014,Abril,Andorra,1,9,0,10
2014,Abril,Angola,7,30,0,37
2014,Abril,Antigua y Barbuda,1,1,0,2
2014,Abril,Países Bajos,1095,1582,0,2677
2014,Abril,Arabia Saudita,1,23,0,24
2014,Abril,Argelia,1,6,0,7
2014,Abril,Argentina,4134,5170,0,9304
2014,Abril,República de Armenia,1,2,0,3
2014,Abril,Australia,348,593,0,941
2014,Abril,Austria,111,205,0,316
2014,Abril,Azerbaiyán,1,2,0,3
2014,Abril,Bahamas,4,23,0,27
2014,Abril,Bahréin,1,2,0,3
2014,Abril,Bangladesh,2,17,0,19
2014,Abril,Barbados,4,5,0,9
2014,Abril,República de Belarús,2,2,0,4
2014,Abril,Bélgica,157,360,0,517
2014,Abril,Belice,5,9,0,14
2014,Abril,Benín,0,3,0,3
2014,Abril,Bolivia,305,407,0,712
2014,Abril,Bosnia y Herzegovina,2,2,0,4
2014,Abril,Botsuana,6,7,0,13
2014,Abril,Brasil,4353,5560,0,9913
2014,Abril,Brunei Darussalam,0,1,0,1
2014,Abril,Bulgaria,21,31,0,52
2014,Abril,Burkina Faso,3,3,0,6
2014,Abril,Burundi,3,9,0,12
2014,Abril,Bután,2,5,0,7
2014,Abril,Cabo Verde,1,0,0,1
2014,Abril,Islas Caimán/Territorio Británico de Ultramar,7,20,0,27
2014,Abril,Camboya,0,1,0,1
2014,Abril,Camerún,7,24,0,31
2014,Abril,Canadá,934,1680,0,2614
2014,Abril,Chad,2,9,0,11
2014,Abril,España,2539,5680,0,8219
2014,Abril,República Del Congo,1,1,0,2
2014,Abril,República Democrática del Congo,1,6,0,7
2014,Abril,República de Corea,184,475,0,659
2014,Abril,Costa de Marfil,1,4,0,5
2014,Abril,Costa Rica,913,1279,0,2192
2014,Abril,Croacia,18,90,0,108
2014,Abril,Cuba,131,273,0,404
2014,Abril,República Checa,30,45,0,75
2014,Abril,Chile,3034,4078,0,7112
2014,Abril,China,251,692,0,943
2014,Abril,Chipre,0,5,0,5
2014,Abril,Dinamarca,92,153,0,245
2014,Abril,Dominica,0,5,0,5
2014,Abril,Ecuador,4632,6116,0,10748
2014,Abril,Egipto,10,25,0,35
2014,Abril,El Salvador,545,720,0,1265
2014,Abril,Emiratos Árabes,2,9,0,11
2014,Abril,Eritrea,0,2,0,2
2014,Abril,Eslovaquia,20,29,0,49
2014,Abril,Eslovenia,23,42,0,65
2014,Abril,Estados Unidos de América,8600,16390,0,24990
2014,Abril,Estonia,5,6,0,11
2014,Abril,Etiopia,6,23,0,29
2014,Abril,Islas Fiji,1,3,0,4
2014,Abril,Filipinas,33,202,0,235
2014,Abril,Finlandia,53,104,0,157
2014,Abril,Francia,1316,2234,0,3550
2014,Abril,Gabón,0,1,0,1
2014,Abril,Gambia,1,13,0,14
2014,Abril,Georgia,1,2,0,3
2014,Abril,Ghana,17,56,0,73
2014,Abril,Granada,1,2,0,3
2014,Abril,Grecia,26,90,0,116
2014,Abril,Guatemala,439,847,0,1286
2014,Abril,Guyana,9,12,0,21
2014,Abril,Haití,12,28,0,40
2014,Abril,Honduras,216,338,0,554
2014,Abril,Hungría,22,40,0,62
2014,Abril,India,48,294,0,342
2014,Abril,Indonesia,18,43,0,61
2014,Abril,Iraq,0,8,0,8
2014,Abril,Irán,6,20,0,26
2014,Abril,República de Irlanda,85,157,0,242
2014,Abril,Islandia,4,7,0,11
2014,Abril,Israel,181,692,0,873
2014,Abril,Italia,564,1639,0,2203
2014,Abril,Jamaica,13,42,0,55
2014,Abril,Japón,153,532,0,685
2014,Abril,Jordania,6,11,0,17
2014,Abril,Kazajistán,3,2,0,5
2014,Abril,Kenia,33,56,0,89
2014,Abril,Kiribati,2,0,0,2
2014,Abril,Kuwait,3,5,0,8
2014,Abril,República de Kosovo,2,1,0,3
2014,Abril,República Democrática Popular  Lao,1,0,0,1
2014,Abril,Lesoto,8,2,0,10
2014,Abril,Letonia,5,9,0,14
2014,Abril,Lituania,13,18,0,31
2014,Abril,Líbano,15,44,0,59
2014,Abril,Liberia,1,0,0,1
2014,Abril,Libia,0,12,0,12
2014,Abril,Liechtenstein,3,1,0,4
2014,Abril,Luxemburgo,8,9,0,17
2014,Abril,Macedonia,0,1,0,1
2014,Abril,Madagascar,4,1,0,5
2014,Abril,Malasia,24,41,0,65
2014,Abril,Malawi,2,4,0,6
2014,Abril,Maldivas,2,0,0,2
2014,Abril,Malí,0,4,0,4
2014,Abril,Malta,5,5,0,10
2014,Abril,Marruecos,7,14,0,21
2014,Abril,Islas Marshall,0,1,0,1
2014,Abril,Mauricio,1,2,0,3
2014,Abril,México,3468,6073,0,9541
2014,Abril,República de Moldavia,2,0,0,2
2014,Abril,Mónaco,0,1,0,1
2014,Abril,Montenegro,2,2,0,4
2014,Abril,Mozambique,4,10,0,14
2014,Abril,Myanmar,4,10,0,14
2014,Abril,Namibia,3,7,0,10
2014,Abril,Nepal,4,9,0,13
2014,Abril,Nicaragua,76,107,0,183
2014,Abril,Nigeria,13,65,0,78
2014,Abril,Níger,0,3,0,3
2014,Abril,Noruega,115,141,0,256
2014,Abril,Nueva Zelanda,54,95,0,149
2014,Abril,Omán,0,2,0,2
2014,Abril,Papúa Nueva Guinea,0,1,0,1
2014,Abril,Pakistán,1,7,0,8
2014,Abril,Panamá,1005,1473,0,2478
2014,Abril,Paraguay,165,176,0,341
2014,Abril,Perú,3798,4885,0,8683
2014,Abril,Palestina,3,8,0,11
2014,Abril,Polonia,91,154,0,245
2014,Abril,Portugal,155,394,0,549
2014,Abril,Puerto Rico/Territorio de Estados Unidos,1,1,0,2
2014,Abril,Reino Unido de Gran Bretaña e Irlanda del Norte,974,1928,0,2902
2014,Abril,República CentroÁfricana,0,3,0,3
2014,Abril,Federación de Rusia,153,193,0,346
2014,Abril,República Dominicana,360,571,0,931
2014,Abril,República Democrática Popular de Corea,1,2,0,3
2014,Abril,Rumania,41,66,0,107
2014,Abril,Rwanda,1,3,0,4
2014,Abril,San Cristóbal y Nevis,4,5,0,9
2014,Abril,Samoa Occidental,0,1,0,1
2014,Abril,San  Vicente y las Granadinas,0,2,0,2
2014,Abril,Santa Lucia,3,3,0,6
2014,Abril,Santa Sede/Ciudad del Vaticano,0,1,0,1
2014,Abril,Senegal,5,10,0,15
2014,Abril,Serbia,11,14,0,25
2014,Abril,Sierra Leona,0,2,0,2
2014,Abril,Singapur,7,18,0,25
2014,Abril,República Árabe Siria,1,2,0,3
2014,Abril,Sri Lanka,1,12,0,13
2014,Abril,Sudáfrica,82,134,0,216
2014,Abril,Sudán,5,11,0,16
2014,Abril,Suecia,209,314,0,523
2014,Abril,Suiza,342,611,0,953
2014,Abril,Surinam,16,22,0,38
2014,Abril,Suazilandia,2,5,0,7
2014,Abril,Taiwán,34,91,0,125
2014,Abril,República de Tayikistán,1,0,0,1
2014,Abril,Tailandia,9,14,0,23
2014,Abril,Territorio Británico del Océano Índico/Territorios Británicos de Ultramar,0,1,0,1
2014,Abril,Tanzania,12,22,0,34
2014,Abril,Togo,1,7,0,8
2014,Abril,Trinidad y Tobago,37,78,0,115
2014,Abril,Túnez,5,4,0,9
2014,Abril,Turquía,26,87,0,113
2014,Abril,Tuvalu,0,2,0,2
2014,Abril,Ucrania,20,35,0,55
2014,Abril,Uganda,12,24,0,36
2014,Abril,Uruguay,357,504,0,861
2014,Abril,Venezuela,9128,11189,0,20317
2014,Abril,Vietnam,2,6,0,8
2014,Abril,República Árabe de Yemen,3,5,0,8
2014,Abril,Zambia,4,8,0,12
2014,Abril,Zimbabue,5,13,0,18
2014,Abril,Desconocido,84,141,0,225
2014,Mayo,Albania,7,8,0,15
2014,Mayo,Alemania,1169,2073,0,3242
2014,Mayo,Andorra,0,6,0,6
2014,Mayo,Angola,0,1,0,1
2014,Mayo,Antigua y Barbuda,1,4,0,5
2014,Mayo,Países Bajos,1003,1685,0,2688
2014,Mayo,Arabia Saudita,2,11,0,13
2014,Mayo,Argelia,3,3,0,6
2014,Mayo,Argentina,4038,5761,0,9799
2014,Mayo,República de Armenia,1,2,0,3
2014,Mayo,Australia,322,692,0,1014
2014,Mayo,Austria,91,213,0,304
2014,Mayo,Azerbaiyán,0,3,0,3
2014,Mayo,Bahamas,0,4,0,4
2014,Mayo,Bahréin,1,3,0,4
2014,Mayo,Bangladesh,3,7,0,10
2014,Mayo,Barbados,11,9,0,20
2014,Mayo,República de Belarús,2,3,0,5
2014,Mayo,Bélgica,139,375,0,514
2014,Mayo,Belice,4,14,0,18
2014,Mayo,Benín,0,2,0,2
2014,Mayo,Bermudas/Territorio Británico de Ultramar,0,2,0,2
2014,Mayo,Bolivia,393,543,0,936
2014,Mayo,Bosnia y Herzegovina,0,1,0,1
2014,Mayo,Botsuana,2,0,0,2
2014,Mayo,Brasil,3963,5410,0,9373
2014,Mayo,Brunei Darussalam,0,1,0,1
2014,Mayo,Bulgaria,16,37,0,53
2014,Mayo,Burkina Faso,1,1,0,2
2014,Mayo,Islas Caimán/Territorio Británico de Ultramar,2,4,0,6
2014,Mayo,Camerún,1,1,0,2
2014,Mayo,Canadá,870,1691,0,2561
2014,Mayo,España,2133,5744,0,7877
2014,Mayo,República Democrática del Congo,1,0,0,1
2014,Mayo,República de Corea,158,492,0,650
2014,Mayo,Costa Rica,713,1152,0,1865
2014,Mayo,Croacia,5,44,0,49
2014,Mayo,Cuba,141,273,0,414
2014,Mayo,Curazao,0,1,0,1
2014,Mayo,República Checa,33,27,0,60
2014,Mayo,Chile,4132,5318,0,9450
2014,Mayo,China,194,608,0,802
2014,Mayo,Chipre,4,7,0,11
2014,Mayo,Dinamarca,61,162,0,223
2014,Mayo,República de Yibuti,1,0,0,1
2014,Mayo,Dominica,2,2,0,4
2014,Mayo,Ecuador,3502,5848,0,9350
2014,Mayo,Egipto,6,24,0,30
2014,Mayo,El Salvador,622,870,0,1492
2014,Mayo,Emiratos Árabes,1,6,0,7
2014,Mayo,Eslovaquia,13,14,0,27
2014,Mayo,Eslovenia,6,14,0,20
2014,Mayo,Estados Unidos de América,9607,19101,0,28708
2014,Mayo,Estonia,6,10,0,16
2014,Mayo,Etiopia,2,1,0,3
2014,Mayo,Filipinas,33,270,0,303
2014,Mayo,Finlandia,41,86,0,127
2014,Mayo,Francia,1028,2092,0,3120
2014,Mayo,Georgia,2,3,0,5
2014,Mayo,Ghana,0,5,0,5
2014,Mayo,Granada,0,2,0,2
2014,Mayo,Grecia,20,72,0,92
2014,Mayo,Guatemala,364,733,0,1097
2014,Mayo,Guyana,7,27,0,34
2014,Mayo,Guinea,0,2,0,2
2014,Mayo,Guinea Ecuatorial,1,1,0,2
2014,Mayo,Haití,6,13,0,19
2014,Mayo,Honduras,203,352,0,555
2014,Mayo,Hungría,18,49,0,67
2014,Mayo,India,56,331,0,387
2014,Mayo,Indonesia,12,30,0,42
2014,Mayo,Iraq,2,0,0,2
2014,Mayo,Irán,8,19,0,27
2014,Mayo,República de Irlanda,104,206,0,310
2014,Mayo,Islandia,6,11,0,17
2014,Mayo,Israel,209,939,0,1148
2014,Mayo,Italia,487,1763,0,2250
2014,Mayo,Jamaica,23,65,0,88
2014,Mayo,Japón,137,603,0,740
2014,Mayo,Jordania,3,5,0,8
2014,Mayo,Kazajistán,4,2,0,6
2014,Mayo,Kenia,15,10,0,25
2014,Mayo,Kirguistán,0,1,0,1
2014,Mayo,Kuwait,0,2,0,2
2014,Mayo,República de Kosovo,1,1,0,2
2014,Mayo,Letonia,10,12,0,22
2014,Mayo,Lituania,5,10,0,15
2014,Mayo,Líbano,17,32,0,49
2014,Mayo,Liberia,0,1,0,1
2014,Mayo,Libia,0,1,0,1
2014,Mayo,Liechtenstein,0,1,0,1
2014,Mayo,Luxemburgo,3,13,0,16
2014,Mayo,Macedonia,1,0,0,1
2014,Mayo,Malasia,15,28,0,43
2014,Mayo,Malta,1,4,0,5
2014,Mayo,Marruecos,8,15,0,23
2014,Mayo,Mauricio,1,3,0,4
2014,Mayo,México,2997,6537,0,9534
2014,Mayo,República de Moldavia,3,1,0,4
2014,Mayo,Mongolia,0,1,0,1
2014,Mayo,Mozambique,2,0,0,2
2014,Mayo,Myanmar,3,0,0,3
2014,Mayo,Nepal,0,5,0,5
2014,Mayo,Nicaragua,77,123,0,200
2014,Mayo,Nigeria,1,14,0,15
2014,Mayo,Noruega,61,109,0,170
2014,Mayo,Nueva Zelanda,64,119,0,183
2014,Mayo,Omán,0,2,0,2
2014,Mayo,Papúa Nueva Guinea,1,0,0,1
2014,Mayo,Pakistán,2,6,0,8
2014,Mayo,Panamá,1061,1582,0,2643
2014,Mayo,Paraguay,173,187,0,360
2014,Mayo,Perú,4661,5694,0,10355
2014,Mayo,Palestina,2,2,0,4
2014,Mayo,Polonia,80,173,0,253
2014,Mayo,Portugal,124,371,0,495
2014,Mayo,Puerto Rico/Territorio de Estados Unidos,0,1,0,1
2014,Mayo,Qatar,0,1,0,1
2014,Mayo,Reino Unido de Gran Bretaña e Irlanda del Norte,792,1713,0,2505
2014,Mayo,República CentroÁfricana,1,0,0,1
2014,Mayo,Federación de Rusia,140,206,0,346
2014,Mayo,República Dominicana,316,558,0,874
2014,Mayo,Rumania,37,61,0,98
2014,Mayo,Rwanda,0,1,0,1
2014,Mayo,San Cristóbal y Nevis,1,3,0,4
2014,Mayo,Santa Lucia,3,1,0,4
2014,Mayo,Santa Sede/Ciudad del Vaticano,0,1,0,1
2014,Mayo,Senegal,3,14,0,17
2014,Mayo,Serbia,1,10,0,11
2014,Mayo,Singapur,13,36,0,49
2014,Mayo,República Árabe Siria,1,6,0,7
2014,Mayo,Sri Lanka,1,3,0,4
2014,Mayo,Sudáfrica,33,95,0,128
2014,Mayo,Suecia,137,221,0,358
2014,Mayo,Suiza,297,613,0,910
2014,Mayo,Surinam,22,44,0,66
2014,Mayo,Taiwán,53,87,0,140
2014,Mayo,Tailandia,26,33,0,59
2014,Mayo,Tanzania,0,1,0,1
2014,Mayo,Togo,0,1,0,1
2014,Mayo,Trinidad y Tobago,26,74,0,100
2014,Mayo,Túnez,3,2,0,5
2014,Mayo,Turquía,22,83,0,105
2014,Mayo,Ucrania,16,40,0,56
2014,Mayo,Uganda,1,1,0,2
2014,Mayo,Uruguay,335,561,0,896
2014,Mayo,Uzbekistán,2,0,0,2
2014,Mayo,Venezuela,6746,9533,0,16279
2014,Mayo,Vietnam,0,4,0,4
2014,Mayo,Zambia,0,1,0,1
2014,Mayo,Zimbabue,3,5,0,8
2014,Mayo,Desconocido,55,84,0,139
2014,Junio,Afganistán,0,1,0,1
2014,Junio,Albania,2,1,0,3
2014,Junio,Alemania,1152,1772,0,2924
2014,Junio,Andorra,0,4,0,4
2014,Junio,Antigua y Barbuda,1,2,0,3
2014,Junio,Países Bajos,986,1535,0,2521
2014,Junio,Arabia Saudita,1,9,0,10
2014,Junio,Argelia,1,3,0,4
2014,Junio,Argentina,3204,4697,0,7901
2014,Junio,Aruba,1,0,0,1
2014,Junio,Australia,352,752,0,1104
2014,Junio,Austria,106,217,0,323
2014,Junio,Azerbaiyán,0,3,0,3
2014,Junio,Bahamas,3,15,0,18
2014,Junio,Bahréin,0,1,0,1
2014,Junio,Bangladesh,0,3,0,3
2014,Junio,Barbados,4,4,0,8
2014,Junio,República de Belarús,5,2,0,7
2014,Junio,Bélgica,193,390,0,583
2014,Junio,Belice,2,10,0,12
2014,Junio,Benín,0,1,0,1
2014,Junio,Bermudas/Territorio Británico de Ultramar,0,1,0,1
2014,Junio,Bolivia,516,615,0,1131
2014,Junio,Brasil,2715,3868,0,6583
2014,Junio,Bulgaria,12,25,0,37
2014,Junio,Burkina Faso,1,0,0,1
2014,Junio,Burundi,0,2,0,2
2014,Junio,Cabo Verde,1,1,0,2
2014,Junio,Islas Caimán/Territorio Británico de Ultramar,1,4,0,5
2014,Junio,Camerún,2,4,0,6
2014,Junio,Canadá,993,1713,0,2706
2014,Junio,España,2639,6087,0,8726
2014,Junio,República Democrática del Congo,2,0,0,2
2014,Junio,República de Corea,162,478,0,640
2014,Junio,Costa Rica,675,1119,0,1794
2014,Junio,Croacia,7,54,0,61
2014,Junio,Cuba,156,250,0,406
2014,Junio,Curazao,3,1,0,4
2014,Junio,República Checa,25,36,0,61
2014,Junio,Chile,2317,3544,0,5861
2014,Junio,China,184,469,0,653
2014,Junio,Chipre,2,9,0,11
2014,Junio,Dinamarca,74,126,0,200
2014,Junio,Dominica,1,4,0,5
2014,Junio,Ecuador,3416,5497,0,8913
2014,Junio,Egipto,1,19,0,20
2014,Junio,El Salvador,637,847,0,1484
2014,Junio,Emiratos Árabes,3,6,0,9
2014,Junio,Eslovaquia,17,14,0,31
2014,Junio,Eslovenia,4,19,0,23
2014,Junio,Estados Unidos de América,16623,25092,0,41715
2014,Junio,Estonia,3,5,0,8
2014,Junio,Etiopia,1,0,0,1
2014,Junio,Islas Fiji,1,1,0,2
2014,Junio,Filipinas,37,194,0,231
2014,Junio,Finlandia,39,96,0,135
2014,Junio,Francia,1209,2124,0,3333
2014,Junio,Georgia,1,0,0,1
2014,Junio,Ghana,1,10,0,11
2014,Junio,Granada,1,3,0,4
2014,Junio,Grecia,17,61,0,78
2014,Junio,Guatemala,448,828,0,1276
2014,Junio,Guyana,7,23,0,30
2014,Junio,Guinea,1,1,0,2
2014,Junio,Guinea Ecuatorial,0,1,0,1
2014,Junio,Haití,10,21,0,31
2014,Junio,Honduras,193,317,0,510
2014,Junio,Hong Kong,1,1,0,2
2014,Junio,Hungría,22,34,0,56
2014,Junio,India,53,330,0,383
2014,Junio,Indonesia,15,42,0,57
2014,Junio,Iraq,0,1,0,1
2014,Junio,Irán,3,11,0,14
2014,Junio,República de Irlanda,112,207,0,319
2014,Junio,Islandia,1,25,0,26
2014,Junio,Israel,154,751,0,905
2014,Junio,Italia,617,1741,0,2358
2014,Junio,Jamaica,18,60,0,78
2014,Junio,Japón,153,501,0,654
2014,Junio,Jordania,6,6,0,12
2014,Junio,Kazajistán,2,0,0,2
2014,Junio,Kenia,2,6,0,8
2014,Junio,Kuwait,1,2,0,3
2014,Junio,Letonia,6,33,0,39
2014,Junio,Lituania,9,9,0,18
2014,Junio,Líbano,10,27,0,37
2014,Junio,Liechtenstein,4,2,0,6
2014,Junio,Luxemburgo,1,6,0,7
2014,Junio,Madagascar,0,1,0,1
2014,Junio,Malasia,17,32,0,49
2014,Junio,Malawi,0,1,0,1
2014,Junio,Malta,2,10,0,12
2014,Junio,Marruecos,1,14,0,15
2014,Junio,Mauricio,1,0,0,1
2014,Junio,Mauritania,0,2,0,2
2014,Junio,México,3162,6177,0,9339
2014,Junio,República de Moldavia,1,0,0,1
2014,Junio,Mongolia,0,2,0,2
2014,Junio,Montenegro,0,1,0,1
2014,Junio,Mozambique,0,1,0,1
2014,Junio,Myanmar,1,1,0,2
2014,Junio,Nepal,1,0,0,1
2014,Junio,Nicaragua,86,96,0,182
2014,Junio,Nigeria,12,23,0,35
2014,Junio,Níger,1,0,0,1
2014,Junio,Noruega,123,177,0,300
2014,Junio,Nueva Zelanda,62,113,0,175
2014,Junio,Pakistán,1,12,0,13
2014,Junio,Panamá,1148,1694,0,2842
2014,Junio,Paraguay,169,204,0,373
2014,Junio,Perú,3878,4898,0,8776
2014,Junio,Palestina,1,1,0,2
2014,Junio,Polonia,101,129,0,230
2014,Junio,Portugal,139,407,0,546
2014,Junio,Puerto Rico/Territorio de Estados Unidos,0,1,0,1
2014,Junio,Reino Unido de Gran Bretaña e Irlanda del Norte,808,1738,0,2546
2014,Junio,Federación de Rusia,124,155,0,279
2014,Junio,República Dominicana,457,623,0,1080
2014,Junio,Rumania,32,52,0,84
2014,Junio,Rwanda,0,2,0,2
2014,Junio,San Cristóbal y Nevis,2,5,0,7
2014,Junio,San  Vicente y las Granadinas,0,5,0,5
2014,Junio,Santa Lucia,2,2,0,4
2014,Junio,Senegal,0,1,0,1
2014,Junio,Serbia,6,8,0,14
2014,Junio,Singapur,19,24,0,43
2014,Junio,República Árabe Siria,0,3,0,3
2014,Junio,Sri Lanka,0,2,0,2
2014,Junio,Sudáfrica,23,92,0,115
2014,Junio,Sudán,1,0,0,1
2014,Junio,Suecia,192,292,0,484
2014,Junio,Suiza,363,635,0,998
2014,Junio,Surinam,12,15,0,27
2014,Junio,Taiwán,50,76,0,126
2014,Junio,Tailandia,6,5,0,11
2014,Junio,Trinidad y Tobago,149,196,0,345
2014,Junio,Túnez,1,0,0,1
2014,Junio,Turquía,30,99,0,129
2014,Junio,Ucrania,18,41,0,59
2014,Junio,Uganda,0,1,0,1
2014,Junio,Uruguay,289,459,0,748
2014,Junio,Venezuela,9253,11721,0,20974
2014,Junio,Vietnam,2,2,0,4
2014,Junio,República Árabe de Yemen,0,1,0,1
2014,Junio,Zambia,2,0,0,2
2014,Junio,Zimbabue,0,2,0,2
2014,Junio,Desconocido,41,79,0,120
2014,Julio,Albania,3,6,0,9
2014,Julio,Alemania,2065,2563,0,4628
2014,Julio,Andorra,1,5,0,6
2014,Julio,Antigua y Barbuda,1,1,0,2
2014,Julio,Países Bajos,1894,2494,0,4388
2014,Julio,Arabia Saudita,1,11,0,12
2014,Julio,Argelia,1,2,0,3
2014,Julio,Argentina,4110,5410,0,9520
2014,Julio,República de Armenia,1,3,0,4
2014,Julio,Aruba,1,1,0,2
2014,Julio,Australia,466,836,0,1302
2014,Julio,Austria,245,311,0,556
2014,Julio,Azerbaiyán,0,2,0,2
2014,Julio,Bahamas,3,5,0,8
2014,Julio,Bahréin,0,2,0,2
2014,Julio,Bangladesh,0,1,0,1
2014,Julio,Barbados,9,7,0,16
2014,Julio,República de Belarús,3,1,0,4
2014,Julio,Bélgica,314,584,0,898
2014,Julio,Belice,5,23,0,28
2014,Julio,Bermudas/Territorio Británico de Ultramar,1,7,0,8
2014,Julio,Bolivia,554,640,0,1194
2014,Julio,Bosnia y Herzegovina,1,1,0,2
2014,Julio,Botsuana,4,1,0,5
2014,Julio,Brasil,4523,5663,0,10186
2014,Julio,Bulgaria,14,33,0,47
2014,Julio,Burkina Faso,0,1,0,1
2014,Julio,Burundi,1,0,0,1
2014,Julio,Cabo Verde,3,1,0,4
2014,Julio,Islas Caimán/Territorio Británico de Ultramar,1,5,0,6
2014,Julio,Camerún,1,3,0,4
2014,Julio,Canadá,1248,2041,0,3289
2014,Julio,España,3003,5992,0,8995
2014,Julio,República Democrática del Congo,5,2,0,7
2014,Julio,República de Corea,227,468,0,695
2014,Julio,Costa de Marfil,3,4,0,7
2014,Julio,Costa Rica,832,1220,0,2052
2014,Julio,Croacia,11,47,0,58
2014,Julio,Cuba,210,341,0,551
2014,Julio,República Checa,53,60,0,113
2014,Julio,Chile,4051,4899,0,8950
2014,Julio,China,237,497,0,734
2014,Julio,Chipre,4,12,0,16
2014,Julio,Dinamarca,116,177,0,293
2014,Julio,Dominica,2,2,0,4
2014,Julio,Ecuador,5112,6997,0,12109
2014,Julio,Egipto,5,32,0,37
2014,Julio,El Salvador,698,924,0,1622
2014,Julio,Emiratos Árabes,0,6,0,6
2014,Julio,Eritrea,1,2,0,3
2014,Julio,Eslovaquia,18,12,0,30
2014,Julio,Eslovenia,19,31,0,50
2014,Julio,Estados Unidos de América,16159,24579,0,40738
2014,Julio,Estonia,7,4,0,11
2014,Julio,Etiopia,4,3,0,7
2014,Julio,Islas Fiji,0,7,0,7
2014,Julio,Filipinas,32,242,0,274
2014,Julio,Finlandia,52,57,0,109
2014,Julio,Francia,2192,3319,0,5511
2014,Julio,Georgia,3,5,0,8
2014,Julio,Ghana,2,12,0,14
2014,Julio,Granada,4,7,0,11
2014,Julio,Grecia,33,100,0,133
2014,Julio,Guatemala,332,790,0,1122
2014,Julio,Guyana,5,18,0,23
2014,Julio,Guinea,0,1,0,1
2014,Julio,Guinea Ecuatorial,3,1,0,4
2014,Julio,Haití,8,41,0,49
2014,Julio,Honduras,181,412,0,593
2014,Julio,Hong Kong,1,0,0,1
2014,Julio,Hungría,23,61,0,84
2014,Julio,India,65,335,0,400
2014,Julio,Indonesia,14,19,0,33
2014,Julio,Iraq,1,3,0,4
2014,Julio,Irán,3,12,0,15
2014,Julio,República de Irlanda,172,268,0,440
2014,Julio,Islandia,7,14,0,21
2014,Julio,Israel,213,742,0,955
2014,Julio,Italia,766,2044,0,2810
2014,Julio,Jamaica,25,42,0,67
2014,Julio,Islas Salomón,1,0,0,1
2014,Julio,Japón,236,809,0,1045
2014,Julio,Jordania,0,4,0,4
2014,Julio,Kazajistán,4,3,0,7
2014,Julio,Kenia,3,16,0,19
2014,Julio,Kirguistán,1,3,0,4
2014,Julio,Kuwait,0,1,0,1
2014,Julio,República de Kosovo,1,0,0,1
2014,Julio,República Democrática Popular  Lao,2,0,0,2
2014,Julio,Letonia,10,13,0,23
2014,Julio,Lituania,15,27,0,42
2014,Julio,Líbano,17,32,0,49
2014,Julio,Liechtenstein,3,1,0,4
2014,Julio,Luxemburgo,9,9,0,18
2014,Julio,Macedonia,1,5,0,6
2014,Julio,Malasia,14,29,0,43
2014,Julio,Malí,0,1,0,1
2014,Julio,Malta,5,8,0,13
2014,Julio,Marruecos,2,13,0,15
2014,Julio,Mauricio,0,2,0,2
2014,Julio,Mauritania,0,4,0,4
2014,Julio,México,4310,7372,0,11682
2014,Julio,República de Moldavia,2,0,0,2
2014,Julio,Mónaco,1,1,0,2
2014,Julio,Mongolia,1,0,0,1
2014,Julio,Montenegro,2,1,0,3
2014,Julio,Nepal,1,5,0,6
2014,Julio,Nicaragua,123,122,0,245
2014,Julio,Nigeria,14,18,0,32
2014,Julio,Noruega,118,180,0,298
2014,Julio,Nueva Zelanda,81,148,0,229
2014,Julio,Pakistán,1,13,0,14
2014,Julio,Panamá,1200,1809,0,3009
2014,Julio,Paraguay,172,202,0,374
2014,Julio,Perú,5975,6825,0,12800
2014,Julio,Palestina,1,1,0,2
2014,Julio,Polonia,164,187,0,351
2014,Julio,Portugal,353,797,0,1150
2014,Julio,Qatar,0,8,0,8
2014,Julio,Reino Unido de Gran Bretaña e Irlanda del Norte,1345,2304,0,3649
2014,Julio,Federación de Rusia,156,179,0,335
2014,Julio,República Dominicana,424,665,0,1089
2014,Julio,Rumania,36,50,0,86
2014,Julio,Rwanda,0,1,0,1
2014,Julio,San Cristóbal y Nevis,2,3,0,5
2014,Julio,San  Vicente y las Granadinas,0,3,0,3
2014,Julio,Santa Lucia,2,3,0,5
2014,Julio,Senegal,0,5,0,5
2014,Julio,Serbia,7,11,0,18
2014,Julio,Sierra Leona,0,2,0,2
2014,Julio,Singapur,14,28,0,42
2014,Julio,República Árabe Siria,0,6,0,6
2014,Julio,Sri Lanka,2,5,0,7
2014,Julio,Sudáfrica,46,122,0,168
2014,Julio,Suecia,159,270,0,429
2014,Julio,Suiza,706,946,0,1652
2014,Julio,Surinam,24,38,0,62
2014,Julio,Taiwán,59,85,0,144
2014,Julio,Tailandia,8,8,0,16
2014,Julio,Tanzania,1,0,0,1
2014,Julio,Trinidad y Tobago,51,98,0,149
2014,Julio,Túnez,2,6,0,8
2014,Julio,Turquía,35,100,0,135
2014,Julio,Ucrania,26,27,0,53
2014,Julio,Uganda,0,3,0,3
2014,Julio,Uruguay,415,553,0,968
2014,Julio,Uzbekistán,1,1,0,2
2014,Julio,Venezuela,12066,14039,0,26105
2014,Julio,Vietnam,3,9,0,12
2014,Julio,Zambia,0,1,0,1
2014,Julio,Zimbabue,0,3,0,3
2014,Julio,Anguila/Territorio Británico de Ultramar,0,1,0,1
2014,Julio,Islas Turcas y Caicos/Territorio Británico de Ultramar,1,1,0,2
2014,Julio,Desconocido,44,79,0,123
2014,Agosto,Afganistán,0,1,0,1
2014,Agosto,Albania,0,3,0,3
2014,Agosto,Alemania,2261,2902,0,5163
2014,Agosto,Andorra,1,6,0,7
2014,Agosto,Angola,2,5,0,7
2014,Agosto,Antigua y Barbuda,2,8,0,10
2014,Agosto,Países Bajos,889,1592,0,2481
2014,Agosto,Arabia Saudita,6,19,0,25
2014,Agosto,Argelia,2,5,0,7
2014,Agosto,Argentina,4472,6095,0,10567
2014,Agosto,República de Armenia,1,2,0,3
2014,Agosto,Aruba,1,0,0,1
2014,Agosto,Australia,407,741,0,1148
2014,Agosto,Austria,208,326,0,534
2014,Agosto,Azerbaiyán,1,3,0,4
2014,Agosto,Bahamas,4,7,0,11
2014,Agosto,Bahréin,0,1,0,1
2014,Agosto,Bangladesh,0,7,0,7
2014,Agosto,Barbados,12,17,0,29
2014,Agosto,República de Belarús,3,3,0,6
2014,Agosto,Bélgica,204,443,0,647
2014,Agosto,Belice,10,19,0,29
2014,Agosto,Benín,0,1,0,1
2014,Agosto,Bermudas/Territorio Británico de Ultramar,1,2,0,3
2014,Agosto,Bolivia,590,615,0,1205
2014,Agosto,Bosnia y Herzegovina,0,2,0,2
2014,Agosto,Brasil,5512,6628,0,12140
2014,Agosto,Brunei Darussalam,0,3,0,3
2014,Agosto,Bulgaria,20,27,0,47
2014,Agosto,Burkina Faso,1,2,0,3
2014,Agosto,Cabo Verde,1,3,0,4
2014,Agosto,Islas Caimán/Territorio Británico de Ultramar,3,5,0,8
2014,Agosto,Camboya,1,0,0,1
2014,Agosto,Camerún,0,3,0,3
2014,Agosto,Canadá,1068,1830,0,2898
2014,Agosto,España,3576,6549,0,10125
2014,Agosto,República Del Congo,0,1,0,1
2014,Agosto,República Democrática del Congo,2,6,0,8
2014,Agosto,República de Corea,200,521,0,721
2014,Agosto,Costa de Marfil,1,4,0,5
2014,Agosto,Costa Rica,828,1314,0,2142
2014,Agosto,Croacia,10,40,0,50
2014,Agosto,Cuba,209,384,0,593
2014,Agosto,Curazao,0,1,0,1
2014,Agosto,República Checa,41,46,0,87
2014,Agosto,Chile,4342,5324,0,9666
2014,Agosto,China,227,577,0,804
2014,Agosto,Chipre,5,4,0,9
2014,Agosto,Dinamarca,59,130,0,189
2014,Agosto,Dominica,4,1,0,5
2014,Agosto,Ecuador,6022,8251,0,14273
2014,Agosto,Egipto,5,23,0,28
2014,Agosto,El Salvador,829,1021,0,1850
2014,Agosto,Emiratos Árabes,3,6,0,9
2014,Agosto,Eritrea,0,2,0,2
2014,Agosto,Eslovaquia,16,16,0,32
2014,Agosto,Eslovenia,10,22,0,32
2014,Agosto,Estados Unidos de América,12185,21865,0,34050
2014,Agosto,Estonia,7,4,0,11
2014,Agosto,Etiopia,4,6,0,10
2014,Agosto,Islas Fiji,4,1,0,5
2014,Agosto,Filipinas,54,201,0,255
2014,Agosto,Finlandia,48,77,0,125
2014,Agosto,Francia,1967,3075,0,5042
2014,Agosto,Georgia,3,1,0,4
2014,Agosto,Ghana,5,10,0,15
2014,Agosto,Granada,2,9,0,11
2014,Agosto,Grecia,35,76,0,111
2014,Agosto,Guatemala,391,998,0,1389
2014,Agosto,Guyana,7,17,0,24
2014,Agosto,Guinea,1,1,0,2
2014,Agosto,Guinea Ecuatorial,0,8,0,8
2014,Agosto,Haití,13,35,0,48
2014,Agosto,Honduras,258,391,0,649
2014,Agosto,Hong Kong,0,1,0,1
2014,Agosto,Hungría,21,44,0,65
2014,Agosto,India,56,329,0,385
2014,Agosto,Indonesia,15,36,0,51
2014,Agosto,Iraq,0,1,0,1
2014,Agosto,Irán,5,18,0,23
2014,Agosto,República de Irlanda,157,246,0,403
2014,Agosto,Islandia,0,8,0,8
2014,Agosto,Israel,162,652,0,814
2014,Agosto,Italia,1048,2553,0,3601
2014,Agosto,Jamaica,26,56,0,82
2014,Agosto,Japón,205,612,0,817
2014,Agosto,Jordania,2,2,0,4
2014,Agosto,Kazajistán,2,8,0,10
2014,Agosto,Kenia,10,24,0,34
2014,Agosto,Kirguistán,2,1,0,3
2014,Agosto,Kuwait,3,5,0,8
2014,Agosto,República de Kosovo,0,2,0,2
2014,Agosto,República Democrática Popular  Lao,0,2,0,2
2014,Agosto,Letonia,7,5,0,12
2014,Agosto,Lituania,13,15,0,28
2014,Agosto,Líbano,17,26,0,43
2014,Agosto,Libia,0,1,0,1
2014,Agosto,Liechtenstein,6,10,0,16
2014,Agosto,Luxemburgo,31,39,0,70
2014,Agosto,Macedonia,3,3,0,6
2014,Agosto,Malasia,22,27,0,49
2014,Agosto,Malawi,0,1,0,1
2014,Agosto,Malí,0,4,0,4
2014,Agosto,Malta,3,5,0,8
2014,Agosto,Marruecos,12,18,0,30
2014,Agosto,Mauricio,0,1,0,1
2014,Agosto,México,3523,6739,0,10262
2014,Agosto,República de Moldavia,4,1,0,5
2014,Agosto,Mónaco,1,0,0,1
2014,Agosto,Micronesia,2,0,0,2
2014,Agosto,Mozambique,1,5,0,6
2014,Agosto,Myanmar,0,3,0,3
2014,Agosto,Namibia,0,2,0,2
2014,Agosto,Nepal,1,3,0,4
2014,Agosto,Nicaragua,103,137,0,240
2014,Agosto,Nigeria,10,14,0,24
2014,Agosto,Noruega,52,129,0,181
2014,Agosto,Nueva Zelanda,79,146,0,225
2014,Agosto,Papúa Nueva Guinea,2,2,0,4
2014,Agosto,Pakistán,4,13,0,17
2014,Agosto,Palau,2,0,0,2
2014,Agosto,Panamá,1876,2749,0,4625
2014,Agosto,Paraguay,187,212,0,399
2014,Agosto,Perú,6636,7436,0,14072
2014,Agosto,Palestina,2,9,0,11
2014,Agosto,Polonia,136,200,0,336
2014,Agosto,Portugal,316,634,0,950
2014,Agosto,Qatar,0,8,0,8
2014,Agosto,Reino Unido de Gran Bretaña e Irlanda del Norte,1064,1991,0,3055
2014,Agosto,República CentroÁfricana,5,0,0,5
2014,Agosto,Federación de Rusia,148,179,0,327
2014,Agosto,República Dominicana,479,772,0,1251
2014,Agosto,Rumania,38,58,0,96
2014,Agosto,Rwanda,0,3,0,3
2014,Agosto,San Cristóbal y Nevis,2,3,0,5
2014,Agosto,Samoa Occidental,3,2,0,5
2014,Agosto,San  Vicente y las Granadinas,0,8,0,8
2014,Agosto,Santa Lucia,7,7,0,14
2014,Agosto,Senegal,1,8,0,9
2014,Agosto,Serbia,8,10,0,18
2014,Agosto,Singapur,19,25,0,44
2014,Agosto,República Árabe Siria,0,4,0,4
2014,Agosto,Sri Lanka,4,9,0,13
2014,Agosto,Sudáfrica,36,98,0,134
2014,Agosto,Sudán,0,1,0,1
2014,Agosto,Suecia,135,207,0,342
2014,Agosto,Suiza,392,647,0,1039
2014,Agosto,Surinam,12,32,0,44
2014,Agosto,Taiwán,64,89,0,153
2014,Agosto,Tailandia,10,11,0,21
2014,Agosto,Togo,0,1,0,1
2014,Agosto,Trinidad y Tobago,33,111,0,144
2014,Agosto,Túnez,1,7,0,8
2014,Agosto,Turquía,55,108,0,163
2014,Agosto,Ucrania,16,33,0,49
2014,Agosto,Uganda,2,4,0,6
2014,Agosto,Uruguay,423,626,0,1049
2014,Agosto,Uzbekistán,1,0,0,1
2014,Agosto,Venezuela,15347,17272,0,32619
2014,Agosto,Vietnam,3,9,0,12
2014,Agosto,República Árabe de Yemen,0,1,0,1
2014,Agosto,Zambia,2,3,0,5
2014,Agosto,Zimbabue,0,8,0,8
2014,Agosto,Desconocido,39,90,0,129
2014,Septiembre,Albania,0,1,0,1
2014,Septiembre,Alemania,1498,2393,0,3891
2014,Septiembre,Andorra,1,8,0,9
2014,Septiembre,Angola,0,1,0,1
2014,Septiembre,Antigua y Barbuda,1,7,0,8
2014,Septiembre,Países Bajos,875,1615,0,2490
2014,Septiembre,Arabia Saudita,2,10,0,12
2014,Septiembre,Argelia,6,6,0,12
2014,Septiembre,Argentina,4044,5563,0,9607
2014,Septiembre,República de Armenia,3,2,0,5
2014,Septiembre,Australia,385,656,0,1041
2014,Septiembre,Austria,119,252,0,371
2014,Septiembre,Azerbaiyán,0,2,0,2
2014,Septiembre,Bahamas,5,4,0,9
2014,Septiembre,Bangladesh,0,12,0,12
2014,Septiembre,Barbados,3,7,0,10
2014,Septiembre,República de Belarús,6,0,0,6
2014,Septiembre,Bélgica,134,367,0,501
2014,Septiembre,Belice,6,10,0,16
2014,Septiembre,Benín,1,0,0,1
2014,Septiembre,Bermudas/Territorio Británico de Ultramar,0,2,0,2
2014,Septiembre,Bolivia,510,633,0,1143
2014,Septiembre,Botsuana,2,2,0,4
2014,Septiembre,Brasil,5866,7038,0,12904
2014,Septiembre,Bulgaria,14,28,0,42
2014,Septiembre,Burkina Faso,0,1,0,1
2014,Septiembre,Bután,0,1,0,1
2014,Septiembre,Cabo Verde,0,1,0,1
2014,Septiembre,Islas Caimán/Territorio Británico de Ultramar,4,2,0,6
2014,Septiembre,Camboya,1,0,0,1
2014,Septiembre,Camerún,0,5,0,5
2014,Septiembre,Canadá,718,1502,0,2220
2014,Septiembre,España,2466,6294,0,8760
2014,Septiembre,República Democrática del Congo,0,4,0,4
2014,Septiembre,República de Corea,167,510,0,677
2014,Septiembre,Costa de Marfil,0,6,0,6
2014,Septiembre,Costa Rica,805,1301,0,2106
2014,Septiembre,Croacia,9,45,0,54
2014,Septiembre,Cuba,173,286,0,459
2014,Septiembre,Curazao,0,1,0,1
2014,Septiembre,República Checa,36,66,0,102
2014,Septiembre,Chile,4479,5563,0,10042
2014,Septiembre,China,205,544,0,749
2014,Septiembre,Chipre,1,7,0,8
2014,Septiembre,Dinamarca,51,136,0,187
2014,Septiembre,Dominica,0,2,0,2
2014,Septiembre,Ecuador,3919,6313,0,10232
2014,Septiembre,Egipto,5,28,0,33
2014,Septiembre,El Salvador,642,886,0,1528
2014,Septiembre,Emiratos Árabes,0,5,0,5
2014,Septiembre,Eslovaquia,22,34,0,56
2014,Septiembre,Eslovenia,11,25,0,36
2014,Septiembre,Estados Unidos de América,7142,15784,0,22926
2014,Septiembre,Estonia,2,6,0,8
2014,Septiembre,Etiopia,2,3,0,5
2014,Septiembre,Islas Fiji,0,1,0,1
2014,Septiembre,Filipinas,23,251,0,274
2014,Septiembre,Finlandia,33,76,0,109
2014,Septiembre,Francia,934,2014,0,2948
2014,Septiembre,Georgia,9,27,0,36
2014,Septiembre,Ghana,1,2,0,3
2014,Septiembre,Granada,0,1,0,1
2014,Septiembre,Grecia,26,67,0,93
2014,Septiembre,Guatemala,355,789,0,1144
2014,Septiembre,Guyana,3,12,0,15
2014,Septiembre,Guinea Ecuatorial,3,0,0,3
2014,Septiembre,Guinea Bissau,0,2,0,2
2014,Septiembre,Haití,6,29,0,35
2014,Septiembre,Honduras,233,397,0,630
2014,Septiembre,Hong Kong,1,1,0,2
2014,Septiembre,Hungría,16,36,0,52
2014,Septiembre,India,39,344,0,383
2014,Septiembre,Indonesia,5,37,0,42
2014,Septiembre,Irán,4,17,0,21
2014,Septiembre,República de Irlanda,110,217,0,327
2014,Septiembre,Islandia,2,9,0,11
2014,Septiembre,Israel,87,534,0,621
2014,Septiembre,Italia,569,1888,0,2457
2014,Septiembre,Jamaica,10,27,0,37
2014,Septiembre,Japón,161,596,0,757
2014,Septiembre,Jordania,1,3,0,4
2014,Septiembre,Kazajistán,7,5,0,12
2014,Septiembre,Kenia,13,26,0,39
2014,Septiembre,Kuwait,1,1,0,2
2014,Septiembre,República de Kosovo,0,1,0,1
2014,Septiembre,República Democrática Popular  Lao,0,1,0,1
2014,Septiembre,Letonia,3,5,0,8
2014,Septiembre,Lituania,18,18,0,36
2014,Septiembre,Líbano,23,31,0,54
2014,Septiembre,Liechtenstein,1,1,0,2
2014,Septiembre,Luxemburgo,3,8,0,11
2014,Septiembre,Macedonia,1,0,0,1
2014,Septiembre,Madagascar,0,1,0,1
2014,Septiembre,Malasia,14,36,0,50
2014,Septiembre,Malawi,0,1,0,1
2014,Septiembre,Malí,3,0,0,3
2014,Septiembre,Malta,3,5,0,8
2014,Septiembre,Marruecos,11,6,0,17
2014,Septiembre,Mauricio,0,1,0,1
2014,Septiembre,Mauritania,1,0,0,1
2014,Septiembre,México,3270,6626,0,9896
2014,Septiembre,República de Moldavia,4,1,0,5
2014,Septiembre,Mónaco,0,1,0,1
2014,Septiembre,Mongolia,0,3,0,3
2014,Septiembre,Mozambique,1,1,0,2
2014,Septiembre,Myanmar,0,3,0,3
2014,Septiembre,Namibia,1,1,0,2
2014,Septiembre,Nepal,0,2,0,2
2014,Septiembre,Nicaragua,79,110,0,189
2014,Septiembre,Nigeria,1,11,0,12
2014,Septiembre,Noruega,68,162,0,230
2014,Septiembre,Nueva Zelanda,66,115,0,181
2014,Septiembre,Omán,1,2,0,3
2014,Septiembre,Pakistán,2,10,0,12
2014,Septiembre,Panamá,1866,2338,0,4204
2014,Septiembre,Paraguay,169,256,0,425
2014,Septiembre,Perú,4793,5733,0,10526
2014,Septiembre,Palestina,4,9,0,13
2014,Septiembre,Polonia,111,179,0,290
2014,Septiembre,Portugal,257,557,0,814
2014,Septiembre,Reino Unido de Gran Bretaña e Irlanda del Norte,735,1741,0,2476
2014,Septiembre,República CentroÁfricana,0,3,0,3
2014,Septiembre,Federación de Rusia,168,204,0,372
2014,Septiembre,República Dominicana,382,606,0,988
2014,Septiembre,Rumania,48,82,0,130
2014,Septiembre,San Cristóbal y Nevis,0,2,0,2
2014,Septiembre,San  Vicente y las Granadinas,0,1,0,1
2014,Septiembre,Santa Sede/Ciudad del Vaticano,0,1,0,1
2014,Septiembre,Senegal,2,2,0,4
2014,Septiembre,Serbia,11,4,0,15
2014,Septiembre,Singapur,15,22,0,37
2014,Septiembre,República Árabe Siria,1,1,0,2
2014,Septiembre,Sri Lanka,0,4,0,4
2014,Septiembre,Sudáfrica,34,100,0,134
2014,Septiembre,Suecia,116,228,0,344
2014,Septiembre,Suiza,283,551,0,834
2014,Septiembre,Surinam,54,43,0,97
2014,Septiembre,Suazilandia,0,1,0,1
2014,Septiembre,Taiwán,61,104,0,165
2014,Septiembre,Tailandia,5,11,0,16
2014,Septiembre,Tanzania,1,10,0,11
2014,Septiembre,Togo,0,2,0,2
2014,Septiembre,Trinidad y Tobago,16,76,0,92
2014,Septiembre,Túnez,1,2,0,3
2014,Septiembre,Turquía,19,97,0,116
2014,Septiembre,Ucrania,11,58,0,69
2014,Septiembre,Uganda,1,7,0,8
2014,Septiembre,Uruguay,385,601,0,986
2014,Septiembre,Uzbekistán,2,0,0,2
2014,Septiembre,Venezuela,11950,14449,0,26399
2014,Septiembre,Vietnam,5,3,0,8
2014,Septiembre,Islas Vírgenes Británicas/Territorio Británico de Ultramar,0,1,0,1
2014,Septiembre,Zimbabue,3,4,0,7
2014,Septiembre,Desconocido,51,99,0,150
2014,Octubre,Albania,1,1,0,2
2014,Octubre,Alemania,1472,2474,0,3946
2014,Octubre,Andorra,1,11,0,12
2014,Octubre,Angola,2,1,0,3
2014,Octubre,Antigua y Barbuda,0,2,0,2
2014,Octubre,Países Bajos,1124,1775,0,2899
2014,Octubre,Arabia Saudita,0,7,0,7
2014,Octubre,Argelia,2,6,0,8
2014,Octubre,Argentina,3933,5562,0,9495
2014,Octubre,República de Armenia,1,2,0,3
2014,Octubre,Australia,312,629,0,941
2014,Octubre,Austria,118,228,0,346
2014,Octubre,Azerbaiyán,2,2,0,4
2014,Octubre,Bahamas,1,7,0,8
2014,Octubre,Bangladesh,0,5,0,5
2014,Octubre,Barbados,2,3,0,5
2014,Octubre,República de Belarús,1,6,0,7
2014,Octubre,Bélgica,175,508,0,683
2014,Octubre,Belice,5,16,0,21
2014,Octubre,Benín,0,1,0,1
2014,Octubre,Bermudas/Territorio Británico de Ultramar,0,3,0,3
2014,Octubre,Bolivia,635,737,0,1372
2014,Octubre,Bosnia y Herzegovina,2,1,0,3
2014,Octubre,Brasil,5631,6655,0,12286
2014,Octubre,Bulgaria,37,42,0,79
2014,Octubre,Islas Caimán/Territorio Británico de Ultramar,1,1,0,2
2014,Octubre,Camboya,1,0,0,1
2014,Octubre,Camerún,1,5,0,6
2014,Octubre,Canadá,868,1714,0,2582
2014,Octubre,España,2628,6612,0,9240
2014,Octubre,República Del Congo,0,1,0,1
2014,Octubre,República Democrática del Congo,0,3,0,3
2014,Octubre,República de Corea,237,649,0,886
2014,Octubre,Costa Rica,746,1257,0,2003
2014,Octubre,Croacia,7,35,0,42
2014,Octubre,Cuba,188,365,0,553
2014,Octubre,República Checa,50,72,0,122
2014,Octubre,Chile,4069,5183,0,9252
2014,Octubre,China,225,573,0,798
2014,Octubre,Chipre,3,3,0,6
2014,Octubre,Dinamarca,79,179,0,258
2014,Octubre,República de Yibuti,0,1,0,1
2014,Octubre,Dominica,4,3,0,7
2014,Octubre,Ecuador,4485,7107,0,11592
2014,Octubre,Egipto,3,19,0,22
2014,Octubre,El Salvador,588,767,0,1355
2014,Octubre,Emiratos Árabes,8,22,0,30
2014,Octubre,Eslovaquia,16,18,0,34
2014,Octubre,Eslovenia,9,21,0,30
2014,Octubre,Estados Unidos de América,7757,16766,0,24523
2014,Octubre,Estonia,25,22,0,47
2014,Octubre,Etiopia,1,6,0,7
2014,Octubre,Islas Fiji,4,11,0,15
2014,Octubre,Filipinas,20,216,0,236
2014,Octubre,Finlandia,51,99,0,150
2014,Octubre,Francia,1266,2352,0,3618
2014,Octubre,Georgia,2,2,0,4
2014,Octubre,Ghana,7,16,0,23
2014,Octubre,Granada,4,3,0,7
2014,Octubre,Grecia,22,70,0,92
2014,Octubre,Guatemala,389,975,0,1364
2014,Octubre,Guyana,5,12,0,17
2014,Octubre,Guinea,1,2,0,3
2014,Octubre,Haití,17,36,0,53
2014,Octubre,Honduras,250,451,0,701
2014,Octubre,Hong Kong,1,0,0,1
2014,Octubre,Hungría,27,37,0,64
2014,Octubre,India,48,295,0,343
2014,Octubre,Indonesia,18,37,0,55
2014,Octubre,Iraq,1,1,0,2
2014,Octubre,Irán,5,20,0,25
2014,Octubre,República de Irlanda,74,198,0,272
2014,Octubre,Islandia,7,7,0,14
2014,Octubre,Israel,129,662,0,791
2014,Octubre,Italia,581,2070,0,2651
2014,Octubre,Jamaica,31,46,0,77
2014,Octubre,Japón,142,583,0,725
2014,Octubre,Jordania,2,5,0,7
2014,Octubre,Kazajistán,2,4,0,6
2014,Octubre,Kenia,7,11,0,18
2014,Octubre,Kuwait,2,3,0,5
2014,Octubre,República de Kosovo,1,1,0,2
2014,Octubre,Letonia,10,19,0,29
2014,Octubre,Lituania,14,23,0,37
2014,Octubre,Líbano,17,36,0,53
2014,Octubre,Liechtenstein,1,2,0,3
2014,Octubre,Luxemburgo,2,7,0,9
2014,Octubre,Madagascar,2,0,0,2
2014,Octubre,Malasia,16,24,0,40
2014,Octubre,Malta,1,9,0,10
2014,Octubre,Marruecos,1,9,0,10
2014,Octubre,Mauricio,0,1,0,1
2014,Octubre,Mauritania,0,2,0,2
2014,Octubre,México,3077,6621,0,9698
2014,Octubre,República de Moldavia,1,0,0,1
2014,Octubre,Mongolia,3,0,0,3
2014,Octubre,Mozambique,1,2,0,3
2014,Octubre,Myanmar,1,2,0,3
2014,Octubre,Namibia,6,2,0,8
2014,Octubre,Nepal,2,2,0,4
2014,Octubre,Nicaragua,92,126,0,218
2014,Octubre,Nigeria,4,21,0,25
2014,Octubre,Níger,0,2,0,2
2014,Octubre,Noruega,70,165,0,235
2014,Octubre,Nueva Zelanda,63,129,0,192
2014,Octubre,Omán,0,8,0,8
2014,Octubre,Papúa Nueva Guinea,1,0,0,1
2014,Octubre,Pakistán,3,5,0,8
2014,Octubre,Panamá,1830,2590,0,4420
2014,Octubre,Paraguay,260,247,0,507
2014,Octubre,Perú,5637,6707,0,12344
2014,Octubre,Palestina,2,1,0,3
2014,Octubre,Polonia,160,238,0,398
2014,Octubre,Portugal,253,629,0,882
2014,Octubre,Qatar,0,1,0,1
2014,Octubre,Reino Unido de Gran Bretaña e Irlanda del Norte,735,2082,0,2817
2014,Octubre,Federación de Rusia,218,341,0,559
2014,Octubre,República Dominicana,421,697,0,1118
2014,Octubre,República Democrática Popular de Corea,0,1,0,1
2014,Octubre,Rumania,41,77,0,118
2014,Octubre,Rwanda,2,1,0,3
2014,Octubre,Samoa Occidental,1,0,0,1
2014,Octubre,San  Vicente y las Granadinas,2,1,0,3
2014,Octubre,Santa Lucia,7,3,0,10
2014,Octubre,Santa Sede/Ciudad del Vaticano,0,3,0,3
2014,Octubre,Senegal,0,5,0,5
2014,Octubre,Serbia,7,8,0,15
2014,Octubre,Singapur,14,21,0,35
2014,Octubre,República Árabe Siria,3,4,0,7
2014,Octubre,Sri Lanka,3,6,0,9
2014,Octubre,Sudáfrica,18,78,0,96
2014,Octubre,Sudán,0,1,0,1
2014,Octubre,Suecia,117,274,0,391
2014,Octubre,Suiza,394,701,0,1095
2014,Octubre,Surinam,20,24,0,44
2014,Octubre,Taiwán,48,84,0,132
2014,Octubre,Tailandia,12,17,0,29
2014,Octubre,Tanzania,1,1,0,2
2014,Octubre,Togo,0,2,0,2
2014,Octubre,Trinidad y Tobago,54,114,0,168
2014,Octubre,Túnez,1,3,0,4
2014,Octubre,Turquía,31,124,0,155
2014,Octubre,Ucrania,34,49,0,83
2014,Octubre,Uganda,3,2,0,5
2014,Octubre,Uruguay,400,645,0,1045
2014,Octubre,Venezuela,11081,14619,0,25700
2014,Octubre,Vietnam,1,0,0,1
2014,Octubre,Zambia,2,1,0,3
2014,Octubre,Zimbabue,3,2,0,5
2014,Octubre,Desconocido,52,125,0,177
2014,Noviembre,Albania,3,5,0,8
2014,Noviembre,Alemania,1676,2887,0,4563
2014,Noviembre,Andorra,1,10,0,11
2014,Noviembre,Antigua y Barbuda,1,6,0,7
2014,Noviembre,Países Bajos,1007,1730,0,2737
2014,Noviembre,Arabia Saudita,0,7,0,7
2014,Noviembre,Argelia,2,4,0,6
2014,Noviembre,Argentina,4470,6071,0,10541
2014,Noviembre,República de Armenia,0,2,0,2
2014,Noviembre,Australia,439,762,0,1201
2014,Noviembre,Austria,187,367,0,554
2014,Noviembre,Azerbaiyán,2,0,0,2
2014,Noviembre,Bahamas,9,8,0,17
2014,Noviembre,Bangladesh,1,7,0,8
2014,Noviembre,Barbados,8,7,0,15
2014,Noviembre,República de Belarús,2,2,0,4
2014,Noviembre,Bélgica,167,427,0,594
2014,Noviembre,Belice,4,14,0,18
2014,Noviembre,Benín,2,0,0,2
2014,Noviembre,Bolivia,665,778,0,1443
2014,Noviembre,Bosnia y Herzegovina,4,3,0,7
2014,Noviembre,Botsuana,1,0,0,1
2014,Noviembre,Brasil,5763,6995,0,12758
2014,Noviembre,Bulgaria,18,31,0,49
2014,Noviembre,Burundi,0,1,0,1
2014,Noviembre,Islas Caimán/Territorio Británico de Ultramar,2,0,0,2
2014,Noviembre,Camboya,0,2,0,2
2014,Noviembre,Camerún,2,5,0,7
2014,Noviembre,Canadá,1096,1997,0,3093
2014,Noviembre,España,2923,7563,0,10486
2014,Noviembre,República Del Congo,0,1,0,1
2014,Noviembre,República Democrática del Congo,4,3,0,7
2014,Noviembre,República de Corea,188,543,0,731
2014,Noviembre,Costa de Marfil,0,4,0,4
2014,Noviembre,Costa Rica,811,1418,0,2229
2014,Noviembre,Croacia,13,74,0,87
2014,Noviembre,Cuba,220,409,0,629
2014,Noviembre,Curazao,0,1,0,1
2014,Noviembre,República Checa,66,105,0,171
2014,Noviembre,Chile,3731,5039,0,8770
2014,Noviembre,China,261,779,0,1040
2014,Noviembre,Chipre,0,8,0,8
2014,Noviembre,Dinamarca,90,174,0,264
2014,Noviembre,Dominica,2,3,0,5
2014,Noviembre,Ecuador,4398,6344,0,10742
2014,Noviembre,Egipto,4,20,0,24
2014,Noviembre,El Salvador,603,799,0,1402
2014,Noviembre,Emiratos Árabes,1,4,0,5
2014,Noviembre,Eritrea,0,1,0,1
2014,Noviembre,Eslovaquia,22,37,0,59
2014,Noviembre,Eslovenia,10,33,0,43
2014,Noviembre,Estados Unidos de América,9355,18826,0,28181
2014,Noviembre,Estonia,4,10,0,14
2014,Noviembre,Etiopia,0,2,0,2
2014,Noviembre,Filipinas,44,204,0,248
2014,Noviembre,Finlandia,66,124,0,190
2014,Noviembre,Francia,1391,2575,0,3966
2014,Noviembre,Gabón,1,0,0,1
2014,Noviembre,Georgia,5,7,0,12
2014,Noviembre,Ghana,2,5,0,7
2014,Noviembre,Gibraltar/Territorio Británico de Ultramar,0,1,0,1
2014,Noviembre,Granada,0,4,0,4
2014,Noviembre,Grecia,14,65,0,79
2014,Noviembre,Guatemala,425,869,0,1294
2014,Noviembre,Guyana,4,16,0,20
2014,Noviembre,Haití,13,16,0,29
2014,Noviembre,Honduras,236,403,0,639
2014,Noviembre,Hong Kong,0,1,0,1
2014,Noviembre,Hungría,51,59,0,110
2014,Noviembre,India,65,335,0,400
2014,Noviembre,Indonesia,12,52,0,64
2014,Noviembre,Iraq,0,1,0,1
2014,Noviembre,Irán,2,28,0,30
2014,Noviembre,República de Irlanda,83,203,0,286
2014,Noviembre,Islandia,6,17,0,23
2014,Noviembre,Israel,116,611,0,727
2014,Noviembre,Italia,682,2369,0,3051
2014,Noviembre,Jamaica,19,39,0,58
2014,Noviembre,Japón,140,609,0,749
2014,Noviembre,Jordania,1,5,0,6
2014,Noviembre,Kazajistán,7,3,0,10
2014,Noviembre,Kenia,10,16,0,26
2014,Noviembre,Kirguistán,3,0,0,3
2014,Noviembre,Kuwait,2,4,0,6
2014,Noviembre,República de Kosovo,3,1,0,4
2014,Noviembre,Letonia,22,30,0,52
2014,Noviembre,Lituania,19,26,0,45
2014,Noviembre,Líbano,13,36,0,49
2014,Noviembre,Libia,0,2,0,2
2014,Noviembre,Liechtenstein,3,4,0,7
2014,Noviembre,Luxemburgo,4,11,0,15
2014,Noviembre,Macedonia,2,2,0,4
2014,Noviembre,Madagascar,1,1,0,2
2014,Noviembre,Malasia,11,40,0,51
2014,Noviembre,Malí,0,2,0,2
2014,Noviembre,Malta,1,4,0,5
2014,Noviembre,Marruecos,1,11,0,12
2014,Noviembre,Islas Marshall,0,1,0,1
2014,Noviembre,Mauricio,0,2,0,2
2014,Noviembre,Mauritania,1,0,0,1
2014,Noviembre,México,2970,6658,0,9628
2014,Noviembre,República de Moldavia,1,0,0,1
2014,Noviembre,Mongolia,2,0,0,2
2014,Noviembre,Montenegro,0,3,0,3
2014,Noviembre,Micronesia,0,1,0,1
2014,Noviembre,Mozambique,0,1,0,1
2014,Noviembre,Myanmar,1,7,0,8
2014,Noviembre,Namibia,0,1,0,1
2014,Noviembre,Nepal,2,3,0,5
2014,Noviembre,Nicaragua,87,118,0,205
2014,Noviembre,Nigeria,1,9,0,10
2014,Noviembre,Noruega,83,192,0,275
2014,Noviembre,Nueva Zelanda,61,140,0,201
2014,Noviembre,Omán,0,4,0,4
2014,Noviembre,Papúa Nueva Guinea,0,1,0,1
2014,Noviembre,Pakistán,1,10,0,11
2014,Noviembre,Panamá,2071,2450,0,4521
2014,Noviembre,Paraguay,288,237,0,525
2014,Noviembre,Perú,4404,5859,0,10263
2014,Noviembre,Palestina,3,1,0,4
2014,Noviembre,Polonia,160,241,0,401
2014,Noviembre,Portugal,267,619,0,886
2014,Noviembre,Puerto Rico/Territorio de Estados Unidos,1,0,0,1
2014,Noviembre,Reino Unido de Gran Bretaña e Irlanda del Norte,920,2032,0,2952
2014,Noviembre,República CentroÁfricana,1,0,0,1
2014,Noviembre,Federación de Rusia,175,369,0,544
2014,Noviembre,República Dominicana,470,781,0,1251
2014,Noviembre,Rumania,50,89,0,139
2014,Noviembre,Rwanda,0,1,0,1
2014,Noviembre,San Cristóbal y Nevis,3,5,0,8
2014,Noviembre,Samoa Occidental,2,0,0,2
2014,Noviembre,San  Vicente y las Granadinas,1,6,0,7
2014,Noviembre,Santa Lucia,5,9,0,14
2014,Noviembre,Senegal,1,0,0,1
2014,Noviembre,Serbia,4,9,0,13
2014,Noviembre,Singapur,11,22,0,33
2014,Noviembre,República Árabe Siria,0,3,0,3
2014,Noviembre,Sri Lanka,0,5,0,5
2014,Noviembre,Sudáfrica,25,101,0,126
2014,Noviembre,Sudán,1,2,0,3
2014,Noviembre,Suecia,226,324,0,550
2014,Noviembre,Suiza,382,766,0,1148
2014,Noviembre,Surinam,13,31,0,44
2014,Noviembre,Taiwán,51,81,0,132
2014,Noviembre,Tailandia,10,5,0,15
2014,Noviembre,Tanzania,1,2,0,3
2014,Noviembre,Togo,0,4,0,4
2014,Noviembre,Trinidad y Tobago,33,74,0,107
2014,Noviembre,Túnez,1,1,0,2
2014,Noviembre,Turquía,37,172,0,209
2014,Noviembre,Ucrania,26,30,0,56
2014,Noviembre,Uganda,1,2,0,3
2014,Noviembre,Uruguay,346,554,0,900
2014,Noviembre,Uzbekistán,1,0,0,1
2014,Noviembre,Venezuela,11477,14854,0,26331
2014,Noviembre,Vietnam,6,20,0,26
2014,Noviembre,República Árabe de Yemen,0,2,0,2
2014,Noviembre,Zambia,1,0,0,1
2014,Noviembre,Zimbabue,2,6,0,8
2014,Noviembre,Anguila/Territorio Británico de Ultramar,1,0,0,1
2014,Noviembre,Islas Turcas y Caicos/Territorio Británico de Ultramar,1,0,0,1
2014,Noviembre,Desconocido,80,128,0,208
2014,Diciembre,Afganistán,0,1,0,1
2014,Diciembre,Albania,2,5,0,7
2014,Diciembre,Alemania,2062,3136,0,5198
2014,Diciembre,Andorra,2,9,0,11
2014,Diciembre,Angola,1,1,0,2
2014,Diciembre,Antigua y Barbuda,3,5,0,8
2014,Diciembre,Países Bajos,1240,2239,0,3479
2014,Diciembre,Arabia Saudita,2,22,0,24
2014,Diciembre,Argelia,1,3,0,4
2014,Diciembre,Argentina,3982,5794,0,9776
2014,Diciembre,República de Armenia,1,1,0,2
2014,Diciembre,Australia,671,1057,0,1728
2014,Diciembre,Austria,181,310,0,491
2014,Diciembre,Azerbaiyán,2,4,0,6
2014,Diciembre,Bahamas,4,4,0,8
2014,Diciembre,Bahréin,0,6,0,6
2014,Diciembre,Bangladesh,0,6,0,6
2014,Diciembre,Barbados,4,6,0,10
2014,Diciembre,República de Belarús,9,8,0,17
2014,Diciembre,Bélgica,224,501,0,725
2014,Diciembre,Belice,3,13,0,16
2014,Diciembre,Benín,1,1,0,2
2014,Diciembre,Bermudas/Territorio Británico de Ultramar,0,3,0,3
2014,Diciembre,Bolivia,734,685,0,1419
2014,Diciembre,Bosnia y Herzegovina,0,2,0,2
2014,Diciembre,Brasil,5921,6286,0,12207
2014,Diciembre,Bulgaria,13,19,0,32
2014,Diciembre,Bután,0,1,0,1
2014,Diciembre,Islas Caimán/Territorio Británico de Ultramar,3,8,0,11
2014,Diciembre,Camerún,0,1,0,1
2014,Diciembre,Canadá,2343,3592,0,5935
2014,Diciembre,España,3107,6366,0,9473
2014,Diciembre,República Del Congo,0,1,0,1
2014,Diciembre,República Democrática del Congo,2,1,0,3
2014,Diciembre,República de Corea,240,453,0,693
2014,Diciembre,Costa de Marfil,0,4,0,4
2014,Diciembre,Costa Rica,1657,1735,0,3392
2014,Diciembre,Croacia,18,58,0,76
2014,Diciembre,Cuba,259,466,0,725
2014,Diciembre,Curazao,1,0,0,1
2014,Diciembre,República Checa,44,54,0,98
2014,Diciembre,Chile,3185,4328,0,7513
2014,Diciembre,China,190,518,0,708
2014,Diciembre,Chipre,5,7,0,12
2014,Diciembre,Dinamarca,145,246,0,391
2014,Diciembre,Dominica,2,2,0,4
2014,Diciembre,Ecuador,5556,7877,0,13433
2014,Diciembre,Egipto,6,16,0,22
2014,Diciembre,El Salvador,554,706,0,1260
2014,Diciembre,Emiratos Árabes,3,18,0,21
2014,Diciembre,Eslovaquia,19,22,0,41
2014,Diciembre,Eslovenia,20,21,0,41
2014,Diciembre,Estados Unidos de América,17496,28436,0,45932
2014,Diciembre,Estonia,26,21,0,47
2014,Diciembre,Etiopia,3,1,0,4
2014,Diciembre,Islas Fiji,1,1,0,2
2014,Diciembre,Filipinas,28,208,0,236
2014,Diciembre,Finlandia,103,117,0,220
2014,Diciembre,Francia,1778,3007,0,4785
2014,Diciembre,Georgia,2,2,0,4
2014,Diciembre,Ghana,1,8,0,9
2014,Diciembre,Granada,0,5,0,5
2014,Diciembre,Grecia,35,82,0,117
2014,Diciembre,Guatemala,457,706,0,1163
2014,Diciembre,Guyana,1,16,0,17
2014,Diciembre,Guinea,1,0,0,1
2014,Diciembre,Guinea Ecuatorial,1,1,0,2
2014,Diciembre,Haití,7,22,0,29
2014,Diciembre,Honduras,233,311,0,544
2014,Diciembre,Hong Kong,0,1,0,1
2014,Diciembre,Hungría,33,46,0,79
2014,Diciembre,India,78,265,0,343
2014,Diciembre,Indonesia,10,48,0,58
2014,Diciembre,Iraq,0,2,0,2
2014,Diciembre,Irán,7,22,0,29
2014,Diciembre,República de Irlanda,111,250,0,361
2014,Diciembre,Islandia,19,25,0,44
2014,Diciembre,Israel,94,541,0,635
2014,Diciembre,Italia,914,2425,0,3339
2014,Diciembre,Jamaica,18,94,0,112
2014,Diciembre,Japón,227,499,0,726
2014,Diciembre,Jordania,0,3,0,3
2014,Diciembre,Kazajistán,7,6,0,13
2014,Diciembre,Kenia,2,8,0,10
2014,Diciembre,Kirguistán,0,5,0,5
2014,Diciembre,Kuwait,0,4,0,4
2014,Diciembre,República de Kosovo,1,0,0,1
2014,Diciembre,Letonia,9,6,0,15
2014,Diciembre,Lituania,21,30,0,51
2014,Diciembre,Líbano,17,52,0,69
2014,Diciembre,Liechtenstein,4,5,0,9
2014,Diciembre,Luxemburgo,5,10,0,15
2014,Diciembre,Macedonia,0,2,0,2
2014,Diciembre,Madagascar,0,1,0,1
2014,Diciembre,Malasia,24,39,0,63
2014,Diciembre,Malta,2,7,0,9
2014,Diciembre,Marruecos,5,20,0,25
2014,Diciembre,Mauricio,2,2,0,4
2014,Diciembre,México,3904,6210,0,10114
2014,Diciembre,República de Moldavia,3,0,0,3
2014,Diciembre,Mónaco,1,2,0,3
2014,Diciembre,Mongolia,0,1,0,1
2014,Diciembre,Montenegro,2,2,0,4
2014,Diciembre,Myanmar,0,10,0,10
2014,Diciembre,Namibia,1,0,0,1
2014,Diciembre,Nepal,3,8,0,11
2014,Diciembre,Nicaragua,72,107,0,179
2014,Diciembre,Nigeria,2,10,0,12
2014,Diciembre,Noruega,180,258,0,438
2014,Diciembre,Nueva Zelanda,87,139,0,226
2014,Diciembre,Pakistán,5,14,0,19
2014,Diciembre,Panamá,1951,2781,0,4732
2014,Diciembre,Paraguay,175,214,0,389
2014,Diciembre,Perú,3970,5144,0,9114
2014,Diciembre,Palestina,0,2,0,2
2014,Diciembre,Polonia,169,223,0,392
2014,Diciembre,Portugal,232,532,0,764
2014,Diciembre,Puerto Rico/Territorio de Estados Unidos,1,0,0,1
2014,Diciembre,Qatar,7,11,0,18
2014,Diciembre,Reino Unido de Gran Bretaña e Irlanda del Norte,1208,2455,0,3663
2014,Diciembre,República CentroÁfricana,0,1,0,1
2014,Diciembre,Federación de Rusia,206,239,0,445
2014,Diciembre,República Dominicana,373,605,0,978
2014,Diciembre,Rumania,43,83,0,126
2014,Diciembre,San Cristóbal y Nevis,1,3,0,4
2014,Diciembre,Samoa Occidental,1,0,0,1
2014,Diciembre,San Marino,0,1,0,1
2014,Diciembre,San  Vicente y las Granadinas,2,5,0,7
2014,Diciembre,Santa Lucia,6,5,0,11
2014,Diciembre,Senegal,1,1,0,2
2014,Diciembre,Serbia,18,10,0,28
2014,Diciembre,Sierra Leona,0,1,0,1
2014,Diciembre,Singapur,20,20,0,40
2014,Diciembre,República Árabe Siria,0,2,0,2
2014,Diciembre,Sri Lanka,0,2,0,2
2014,Diciembre,Sudáfrica,43,66,0,109
2014,Diciembre,Sudán,1,1,0,2
2014,Diciembre,Suecia,439,590,0,1029
2014,Diciembre,Suiza,569,1041,0,1610
2014,Diciembre,Surinam,1,26,0,27
2014,Diciembre,Taiwán,63,54,0,117
2014,Diciembre,Tailandia,3,10,0,13
2014,Diciembre,Tanzania,1,2,0,3
2014,Diciembre,Togo,0,1,0,1
2014,Diciembre,Trinidad y Tobago,32,81,0,113
2014,Diciembre,Túnez,0,8,0,8
2014,Diciembre,Turquía,52,124,0,176
2014,Diciembre,Ucrania,19,28,0,47
2014,Diciembre,Uganda,0,3,0,3
2014,Diciembre,Uruguay,234,392,0,626
2014,Diciembre,Uzbekistán,4,0,0,4
2014,Diciembre,Vanuatu,0,1,0,1
2014,Diciembre,Venezuela,18634,20870,0,39504
2014,Diciembre,Vietnam,3,1,0,4
2014,Diciembre,Islas Vírgenes Británicas/Territorio Británico de Ultramar,1,0,0,1
2014,Diciembre,República Árabe de Yemen,0,1,0,1
2014,Diciembre,Zambia,2,2,0,4
2014,Diciembre,Zimbabue,2,2,0,4
2014,Diciembre,Desconocido,44,73,0,117
2015,Enero,Afganistán,1,0,0,1
2015,Enero,Albania,1,2,0,3
2015,Enero,Alemania,1900,2818,0,4718
2015,Enero,Andorra,4,10,0,14
2015,Enero,Angola,0,1,0,1
2015,Enero,Antigua y Barbuda,1,7,0,8
2015,Enero,Países Bajos,1003,1651,0,2654
2015,Enero,Arabia Saudita,0,5,0,5
2015,Enero,Argelia,3,5,0,8
2015,Enero,Argentina,7474,7592,0,15066
2015,Enero,República de Armenia,1,0,0,1
2015,Enero,Australia,500,784,0,1284
2015,Enero,Austria,166,330,0,496
2015,Enero,Azerbaiyán,1,5,0,6
2015,Enero,Bahamas,7,6,0,13
2015,Enero,Bangladesh,0,9,0,9
2015,Enero,Barbados,3,10,0,13
2015,Enero,República de Belarús,16,11,0,27
2015,Enero,Bélgica,219,441,0,660
2015,Enero,Belice,1,5,0,6
2015,Enero,Bermudas/Territorio Británico de Ultramar,0,3,0,3
2015,Enero,Bolivia,748,800,0,1548
2015,Enero,Bosnia y Herzegovina,1,3,0,4
2015,Enero,Brasil,6264,6923,0,13187
2015,Enero,Brunei Darussalam,1,0,0,1
2015,Enero,Bulgaria,15,30,0,45
2015,Enero,Burkina Faso,0,1,0,1
2015,Enero,Bután,0,1,0,1
2015,Enero,Islas Caimán/Territorio Británico de Ultramar,0,5,0,5
2015,Enero,Camerún,2,0,0,2
2015,Enero,Canadá,2358,3135,0,5493
2015,Enero,España,2802,6567,0,9369
2015,Enero,República Democrática del Congo,2,2,0,4
2015,Enero,República de Corea,364,581,0,945
2015,Enero,Costa Rica,1275,1451,0,2726
2015,Enero,Croacia,23,54,0,77
2015,Enero,Cuba,241,378,0,619
2015,Enero,Curazao,1,1,0,2
2015,Enero,República Checa,66,127,0,193
2015,Enero,Chile,4161,4954,0,9115
2015,Enero,China,231,519,0,750
2015,Enero,Chipre,1,6,0,7
2015,Enero,Dinamarca,124,219,0,343
2015,Enero,Dominica,1,1,0,2
2015,Enero,Ecuador,3896,5880,0,9776
2015,Enero,Egipto,7,33,0,40
2015,Enero,El Salvador,590,777,0,1367
2015,Enero,Emiratos Árabes,2,4,0,6
2015,Enero,Eslovaquia,22,35,0,57
2015,Enero,Eslovenia,38,48,0,86
2015,Enero,Estados Unidos de América,9501,17803,0,27304
2015,Enero,Estonia,18,22,0,40
2015,Enero,Etiopia,0,3,0,3
2015,Enero,Filipinas,33,276,0,309
2015,Enero,Finlandia,88,111,0,199
2015,Enero,Francia,1882,2958,0,4840
2015,Enero,Georgia,1,3,0,4
2015,Enero,Ghana,3,4,0,7
2015,Enero,Grecia,21,86,0,107
2015,Enero,Guatemala,323,757,0,1080
2015,Enero,Guyana,4,17,0,21
2015,Enero,Guayana Francesa/Departamento de Ultramar Francés,0,1,0,1
2015,Enero,Haití,8,22,0,30
2015,Enero,Honduras,202,317,0,519
2015,Enero,Hong Kong,1,0,0,1
2015,Enero,Hungría,35,60,0,95
2015,Enero,India,45,353,0,398
2015,Enero,Indonesia,12,27,0,39
2015,Enero,Iraq,0,23,0,23
2015,Enero,Irán,4,16,0,20
2015,Enero,República de Irlanda,99,250,0,349
2015,Enero,Islandia,15,16,0,31
2015,Enero,Israel,131,661,0,792
2015,Enero,Italia,1039,2797,0,3836
2015,Enero,Jamaica,30,29,0,59
2015,Enero,Islas Salomón,1,0,0,1
2015,Enero,Japón,236,585,0,821
2015,Enero,Jordania,1,3,0,4
2015,Enero,Kazajistán,4,11,0,15
2015,Enero,Kenia,4,7,0,11
2015,Enero,Kirguistán,2,2,0,4
2015,Enero,Kuwait,3,3,0,6
2015,Enero,República de Kosovo,1,0,0,1
2015,Enero,Letonia,7,16,0,23
2015,Enero,Lituania,22,18,0,40
2015,Enero,Líbano,22,24,0,46
2015,Enero,Libia,1,1,0,2
2015,Enero,Liechtenstein,3,0,0,3
2015,Enero,Luxemburgo,8,10,0,18
2015,Enero,Macedonia,2,1,0,3
2015,Enero,Madagascar,1,1,0,2
2015,Enero,Malasia,16,21,0,37
2015,Enero,Malta,2,14,0,16
2015,Enero,Marruecos,7,8,0,15
2015,Enero,Mauricio,0,2,0,2
2015,Enero,Mauritania,0,1,0,1
2015,Enero,México,3154,6046,0,9200
2015,Enero,República de Moldavia,5,0,0,5
2015,Enero,Mónaco,0,1,0,1
2015,Enero,Mongolia,3,0,0,3
2015,Enero,Montenegro,1,4,0,5
2015,Enero,Myanmar,0,4,0,4
2015,Enero,Nepal,0,1,0,1
2015,Enero,Nicaragua,68,95,0,163
2015,Enero,Nigeria,3,8,0,11
2015,Enero,Noruega,140,211,0,351
2015,Enero,Nueva Zelanda,74,117,0,191
2015,Enero,Omán,0,1,0,1
2015,Enero,Pakistán,2,10,0,12
2015,Enero,Panamá,1770,2292,0,4062
2015,Enero,Paraguay,308,244,0,552
2015,Enero,Perú,4610,5807,0,10417
2015,Enero,Palestina,1,3,0,4
2015,Enero,Polonia,172,268,0,440
2015,Enero,Portugal,300,644,0,944
2015,Enero,Reino Unido de Gran Bretaña e Irlanda del Norte,1087,2173,0,3260
2015,Enero,República CentroÁfricana,1,0,0,1
2015,Enero,Federación de Rusia,392,516,0,908
2015,Enero,República Dominicana,342,578,0,920
2015,Enero,Rumania,52,61,0,113
2015,Enero,San Cristóbal y Nevis,0,2,0,2
2015,Enero,Samoa Occidental,1,0,0,1
2015,Enero,San Marino,2,1,0,3
2015,Enero,San  Vicente y las Granadinas,2,2,0,4
2015,Enero,Santa Lucia,0,1,0,1
2015,Enero,Santa Sede/Ciudad del Vaticano,0,1,0,1
2015,Enero,Serbia,13,25,0,38
2015,Enero,Sierra Leona,1,0,0,1
2015,Enero,Singapur,19,30,0,49
2015,Enero,República Árabe Siria,2,4,0,6
2015,Enero,Sri Lanka,0,5,0,5
2015,Enero,Sudáfrica,45,78,0,123
2015,Enero,Suecia,333,485,0,818
2015,Enero,Suiza,564,845,0,1409
2015,Enero,Surinam,10,28,0,38
2015,Enero,Taiwán,67,99,0,166
2015,Enero,Tailandia,4,7,0,11
2015,Enero,Tanzania,0,2,0,2
2015,Enero,Togo,0,1,0,1
2015,Enero,Trinidad y Tobago,20,83,0,103
2015,Enero,Túnez,2,0,0,2
2015,Enero,Turquía,48,170,0,218
2015,Enero,Ucrania,42,76,0,118
2015,Enero,Uganda,1,1,0,2
2015,Enero,Uruguay,421,521,0,942
2015,Enero,Uzbekistán,3,3,0,6
2015,Enero,Venezuela,12775,15378,0,28153
2015,Enero,Vietnam,0,1,0,1
2015,Enero,Zimbabue,0,2,0,2
2015,Enero,Desconocido,33,70,0,103
2015,Febrero,Afganistán,0,1,0,1
2015,Febrero,Albania,2,7,0,9
2015,Febrero,Alemania,1873,3040,0,4913
2015,Febrero,Andorra,2,12,0,14
2015,Febrero,Angola,0,3,0,3
2015,Febrero,Antigua y Barbuda,0,9,0,9
2015,Febrero,Países Bajos,1023,1668,0,2691
2015,Febrero,Arabia Saudita,0,4,0,4
2015,Febrero,Argelia,1,3,0,4
2015,Febrero,Argentina,5839,6754,0,12593
2015,Febrero,República de Armenia,0,1,0,1
2015,Febrero,Australia,366,606,0,972
2015,Febrero,Austria,195,359,0,554
2015,Febrero,Azerbaiyán,1,2,0,3
2015,Febrero,Bahamas,3,14,0,17
2015,Febrero,Bahréin,0,1,0,1
2015,Febrero,Bangladesh,0,3,0,3
2015,Febrero,Barbados,3,9,0,12
2015,Febrero,República de Belarús,4,1,0,5
2015,Febrero,Bélgica,181,416,0,597
2015,Febrero,Belice,1,15,0,16
2015,Febrero,Benín,1,0,0,1
2015,Febrero,Bermudas/Territorio Británico de Ultramar,0,5,0,5
2015,Febrero,Bolivia,381,532,0,913
2015,Febrero,Bosnia y Herzegovina,1,2,0,3
2015,Febrero,Botsuana,0,1,0,1
2015,Febrero,Brasil,6180,6893,0,13073
2015,Febrero,Bulgaria,18,33,0,51
2015,Febrero,Burundi,0,1,0,1
2015,Febrero,Islas Caimán/Territorio Británico de Ultramar,2,3,0,5
2015,Febrero,Camerún,0,10,0,10
2015,Febrero,Canadá,2311,3016,0,5327
2015,Febrero,España,2222,6022,0,8244
2015,Febrero,República Democrática del Congo,3,7,0,10
2015,Febrero,República de Corea,242,439,0,681
2015,Febrero,Costa de Marfil,2,1,0,3
2015,Febrero,Costa Rica,698,1055,0,1753
2015,Febrero,Croacia,14,45,0,59
2015,Febrero,Cuba,183,330,0,513
2015,Febrero,República Checa,41,75,0,116
2015,Febrero,Chile,6040,6475,0,12515
2015,Febrero,China,201,400,0,601
2015,Febrero,Chipre,0,3,0,3
2015,Febrero,Dinamarca,132,228,0,360
2015,Febrero,Dominica,2,4,0,6
2015,Febrero,Ecuador,5033,6576,0,11609
2015,Febrero,Egipto,8,37,0,45
2015,Febrero,El Salvador,596,844,0,1440
2015,Febrero,Emiratos Árabes,3,3,0,6
2015,Febrero,Eritrea,2,3,0,5
2015,Febrero,Eslovaquia,30,26,0,56
2015,Febrero,Eslovenia,16,31,0,47
2015,Febrero,Estados Unidos de América,10912,20106,0,31018
2015,Febrero,Estonia,39,35,0,74
2015,Febrero,Etiopia,2,5,0,7
2015,Febrero,Islas Fiji,0,1,0,1
2015,Febrero,Filipinas,18,235,0,253
2015,Febrero,Finlandia,81,118,0,199
2015,Febrero,Francia,1725,2888,0,4613
2015,Febrero,Georgia,0,1,0,1
2015,Febrero,Ghana,2,10,0,12
2015,Febrero,Granada,1,1,0,2
2015,Febrero,Grecia,41,88,0,129
2015,Febrero,Guatemala,411,893,0,1304
2015,Febrero,Guyana,5,8,0,13
2015,Febrero,Haití,3,22,0,25
2015,Febrero,Honduras,207,332,0,539
2015,Febrero,Hungría,37,56,0,93
2015,Febrero,India,53,360,0,413
2015,Febrero,Indonesia,18,47,0,65
2015,Febrero,Iraq,0,3,0,3
2015,Febrero,Irán,5,13,0,18
2015,Febrero,República de Irlanda,95,197,0,292
2015,Febrero,Islandia,14,13,0,27
2015,Febrero,Israel,109,633,0,742
2015,Febrero,Italia,955,2609,0,3564
2015,Febrero,Jamaica,29,50,0,79
2015,Febrero,Japón,177,626,0,803
2015,Febrero,Jordania,2,7,0,9
2015,Febrero,Kazajistán,9,5,0,14
2015,Febrero,Kenia,1,8,0,9
2015,Febrero,Kirguistán,0,4,0,4
2015,Febrero,Kuwait,0,1,0,1
2015,Febrero,República de Kosovo,1,2,0,3
2015,Febrero,Letonia,10,11,0,21
2015,Febrero,Lituania,27,24,0,51
2015,Febrero,Líbano,24,32,0,56
2015,Febrero,Liberia,1,0,0,1
2015,Febrero,Liechtenstein,1,0,0,1
2015,Febrero,Luxemburgo,5,10,0,15
2015,Febrero,Macedonia,1,2,0,3
2015,Febrero,Madagascar,2,0,0,2
2015,Febrero,Malasia,12,14,0,26
2015,Febrero,Malawi,1,0,0,1
2015,Febrero,Malta,5,4,0,9
2015,Febrero,Marruecos,8,15,0,23
2015,Febrero,México,3124,6315,0,9439
2015,Febrero,República de Moldavia,2,1,0,3
2015,Febrero,Mongolia,1,1,0,2
2015,Febrero,Myanmar,0,2,0,2
2015,Febrero,Namibia,0,2,0,2
2015,Febrero,Nepal,1,1,0,2
2015,Febrero,Nicaragua,87,100,0,187
2015,Febrero,Nigeria,3,5,0,8
2015,Febrero,Noruega,119,188,0,307
2015,Febrero,Nueva Zelanda,46,89,0,135
2015,Febrero,Pakistán,3,12,0,15
2015,Febrero,Panamá,2587,2849,0,5436
2015,Febrero,Paraguay,376,307,0,683
2015,Febrero,Perú,6275,6699,0,12974
2015,Febrero,Palestina,0,2,0,2
2015,Febrero,Polonia,207,330,0,537
2015,Febrero,Portugal,230,537,0,767
2015,Febrero,Qatar,0,1,0,1
2015,Febrero,Reino Unido de Gran Bretaña e Irlanda del Norte,1051,2159,0,3210
2015,Febrero,Federación de Rusia,182,217,0,399
2015,Febrero,República Dominicana,408,656,0,1064
2015,Febrero,Rumania,55,81,0,136
2015,Febrero,Rwanda,2,1,0,3
2015,Febrero,San Cristóbal y Nevis,2,6,0,8
2015,Febrero,San  Vicente y las Granadinas,2,0,0,2
2015,Febrero,Santa Lucia,5,1,0,6
2015,Febrero,Serbia,5,12,0,17
2015,Febrero,Singapur,9,9,0,18
2015,Febrero,República Árabe Siria,1,2,0,3
2015,Febrero,Sri Lanka,0,3,0,3
2015,Febrero,Sudáfrica,42,85,0,127
2015,Febrero,Sudán,0,1,0,1
2015,Febrero,Suecia,243,342,0,585
2015,Febrero,Suiza,562,832,0,1394
2015,Febrero,Surinam,14,25,0,39
2015,Febrero,Taiwán,73,67,0,140
2015,Febrero,Tailandia,9,4,0,13
2015,Febrero,Tanzania,1,5,0,6
2015,Febrero,República Democrática de Timor Oriental,0,1,0,1
2015,Febrero,Togo,0,4,0,4
2015,Febrero,Trinidad y Tobago,35,96,0,131
2015,Febrero,Túnez,1,8,0,9
2015,Febrero,Turquía,73,323,0,396
2015,Febrero,Ucrania,30,37,0,67
2015,Febrero,Uganda,3,1,0,4
2015,Febrero,Uruguay,360,542,0,902
2015,Febrero,Venezuela,9998,12646,0,22644
2015,Febrero,Vietnam,7,9,0,16
2015,Febrero,República Árabe de Yemen,0,1,0,1
2015,Febrero,Zambia,1,2,0,3
2015,Febrero,Zimbabue,2,3,0,5
2015,Febrero,Desconocido,42,82,0,124
2015,Marzo,Albania,2,10,0,12
2015,Marzo,Alemania,2160,3288,0,5448
2015,Marzo,Andorra,3,15,0,18
2015,Marzo,Angola,0,1,0,1
2015,Marzo,Antigua y Barbuda,3,6,0,9
2015,Marzo,Países Bajos,1039,1718,0,2757
2015,Marzo,Arabia Saudita,0,11,0,11
2015,Marzo,Argelia,1,4,0,5
2015,Marzo,Argentina,6367,7649,0,14016
2015,Marzo,República de Armenia,4,5,0,9
2015,Marzo,Australia,331,640,0,971
2015,Marzo,Austria,150,328,0,478
2015,Marzo,Azerbaiyán,2,3,0,5
2015,Marzo,Bahamas,3,16,0,19
2015,Marzo,Bahréin,0,2,0,2
2015,Marzo,Bangladesh,0,12,0,12
2015,Marzo,Barbados,4,8,0,12
2015,Marzo,República de Belarús,5,9,0,14
2015,Marzo,Bélgica,157,427,0,584
2015,Marzo,Belice,7,19,0,26
2015,Marzo,Benín,2,1,0,3
2015,Marzo,Bermudas/Territorio Británico de Ultramar,2,1,0,3
2015,Marzo,Bolivia,367,493,0,860
2015,Marzo,Bosnia y Herzegovina,0,2,0,2
2015,Marzo,Brasil,4864,6403,0,11267
2015,Marzo,Bulgaria,25,28,0,53
2015,Marzo,Burkina Faso,0,1,0,1
2015,Marzo,Burundi,0,2,0,2
2015,Marzo,Cabo Verde,1,0,0,1
2015,Marzo,Islas Caimán/Territorio Británico de Ultramar,3,2,0,5
2015,Marzo,Camerún,1,1,0,2
2015,Marzo,Canadá,1998,2792,0,4790
2015,Marzo,Chad,0,1,0,1
2015,Marzo,España,2782,6601,0,9383
2015,Marzo,República de Corea,201,562,0,763
2015,Marzo,Costa de Marfil,0,2,0,2
2015,Marzo,Costa Rica,1002,1393,0,2395
2015,Marzo,Croacia,14,44,0,58
2015,Marzo,Cuba,219,376,0,595
2015,Marzo,República Checa,46,94,0,140
2015,Marzo,Chile,4088,5521,0,9609
2015,Marzo,China,247,755,0,1002
2015,Marzo,Chipre,3,3,0,6
2015,Marzo,Dinamarca,115,229,0,344
2015,Marzo,Dominica,2,2,0,4
2015,Marzo,Ecuador,4909,7683,0,12592
2015,Marzo,Egipto,4,25,0,29
2015,Marzo,El Salvador,682,908,0,1590
2015,Marzo,Emiratos Árabes,0,28,0,28
2015,Marzo,Eslovaquia,40,27,0,67
2015,Marzo,Eslovenia,12,35,0,47
2015,Marzo,Estados Unidos de América,12738,22622,0,35360
2015,Marzo,Estonia,15,12,0,27
2015,Marzo,Etiopia,1,0,0,1
2015,Marzo,Filipinas,26,336,0,362
2015,Marzo,Finlandia,70,129,0,199
2015,Marzo,Francia,1380,2468,0,3848
2015,Marzo,Georgia,4,13,0,17
2015,Marzo,Ghana,2,9,0,11
2015,Marzo,Granada,0,2,0,2
2015,Marzo,Grecia,25,81,0,106
2015,Marzo,Guatemala,476,985,0,1461
2015,Marzo,Guyana,7,13,0,20
2015,Marzo,Guinea,0,1,0,1
2015,Marzo,Guinea Ecuatorial,2,4,0,6
2015,Marzo,Haití,6,13,0,19
2015,Marzo,Honduras,302,428,0,730
2015,Marzo,Hong Kong,0,1,0,1
2015,Marzo,Hungría,41,51,0,92
2015,Marzo,India,60,439,0,499
2015,Marzo,Indonesia,7,26,0,33
2015,Marzo,Iraq,0,1,0,1
2015,Marzo,Irán,3,10,0,13
2015,Marzo,República de Irlanda,117,236,0,353
2015,Marzo,Islandia,10,15,0,25
2015,Marzo,Israel,226,921,0,1147
2015,Marzo,Italia,936,2479,0,3415
2015,Marzo,Jamaica,12,34,0,46
2015,Marzo,Japón,218,621,0,839
2015,Marzo,Jordania,2,6,0,8
2015,Marzo,Kazajistán,7,5,0,12
2015,Marzo,Kenia,1,15,0,16
2015,Marzo,Kirguistán,0,5,0,5
2015,Marzo,Kuwait,2,3,0,5
2015,Marzo,Letonia,14,13,0,27
2015,Marzo,Lituania,15,16,0,31
2015,Marzo,Líbano,14,42,0,56
2015,Marzo,Liberia,1,0,0,1
2015,Marzo,Liechtenstein,2,7,0,9
2015,Marzo,Luxemburgo,8,8,0,16
2015,Marzo,Macedonia,0,5,0,5
2015,Marzo,Malasia,14,37,0,51
2015,Marzo,Malí,1,1,0,2
2015,Marzo,Malta,2,8,0,10
2015,Marzo,Marruecos,4,11,0,15
2015,Marzo,Mauricio,0,1,0,1
2015,Marzo,México,4194,7880,0,12074
2015,Marzo,República de Moldavia,5,0,0,5
2015,Marzo,Mónaco,1,1,0,2
2015,Marzo,Mongolia,1,2,0,3
2015,Marzo,Montenegro,0,2,0,2
2015,Marzo,Mozambique,0,1,0,1
2015,Marzo,Myanmar,0,2,0,2
2015,Marzo,Nepal,0,1,0,1
2015,Marzo,Nicaragua,67,115,0,182
2015,Marzo,Nigeria,5,10,0,15
2015,Marzo,Noruega,175,209,0,384
2015,Marzo,Nueva Zelanda,66,101,0,167
2015,Marzo,Papúa Nueva Guinea,0,3,0,3
2015,Marzo,Pakistán,4,13,0,17
2015,Marzo,Palau,2,0,0,2
2015,Marzo,Panamá,1447,2084,0,3531
2015,Marzo,Paraguay,299,228,0,527
2015,Marzo,Perú,4820,6150,0,10970
2015,Marzo,Polonia,160,250,0,410
2015,Marzo,Portugal,284,569,0,853
2015,Marzo,Puerto Rico/Territorio de Estados Unidos,0,1,0,1
2015,Marzo,Qatar,1,6,0,7
2015,Marzo,Reino Unido de Gran Bretaña e Irlanda del Norte,1126,2342,0,3468
2015,Marzo,Federación de Rusia,197,306,0,503
2015,Marzo,República Dominicana,387,606,0,993
2015,Marzo,Rumania,47,88,0,135
2015,Marzo,San Cristóbal y Nevis,0,1,0,1
2015,Marzo,San Marino,0,2,0,2
2015,Marzo,Santa Lucia,2,5,0,7
2015,Marzo,Senegal,1,1,0,2
2015,Marzo,Serbia,11,19,0,30
2015,Marzo,Singapur,20,40,0,60
2015,Marzo,República Árabe Siria,1,5,0,6
2015,Marzo,Sri Lanka,0,7,0,7
2015,Marzo,Sudáfrica,46,122,0,168
2015,Marzo,Sudán,0,1,0,1
2015,Marzo,Suecia,222,356,0,578
2015,Marzo,Suiza,440,805,0,1245
2015,Marzo,Surinam,18,30,0,48
2015,Marzo,Taiwán,106,146,0,252
2015,Marzo,Tailandia,30,14,0,44
2015,Marzo,Tanzania,0,3,0,3
2015,Marzo,Trinidad y Tobago,25,81,0,106
2015,Marzo,Túnez,1,4,0,5
2015,Marzo,Turquía,74,139,0,213
2015,Marzo,Ucrania,46,75,0,121
2015,Marzo,Uganda,1,1,0,2
2015,Marzo,Uruguay,433,633,0,1066
2015,Marzo,Uzbekistán,2,1,0,3
2015,Marzo,Venezuela,11501,14165,0,25666
2015,Marzo,Vietnam,5,1,0,6
2015,Marzo,Islas Vírgenes Británicas/Territorio Británico de Ultramar,1,1,0,2
2015,Marzo,República Árabe de Yemen,1,3,0,4
2015,Marzo,Zambia,0,1,0,1
2015,Marzo,Zimbabue,0,4,0,4
2015,Marzo,Islas Turcas y Caicos/Territorio Británico de Ultramar,1,1,0,2
2015,Marzo,Desconocido,50,119,0,169
2015,Abril,Afganistán,0,10,0,10
2015,Abril,Albania,0,1,0,1
2015,Abril,Alemania,1564,2447,0,4011
2015,Abril,Andorra,4,9,0,13
2015,Abril,Angola,0,1,0,1
2015,Abril,Antigua y Barbuda,2,12,0,14
2015,Abril,Países Bajos,1358,2060,0,3418
2015,Abril,Arabia Saudita,1,9,0,10
2015,Abril,Argelia,1,2,0,3
2015,Abril,Argentina,4988,6095,0,11083
2015,Abril,República de Armenia,4,2,0,6
2015,Abril,Aruba,1,1,0,2
2015,Abril,Australia,350,605,0,955
2015,Abril,Austria,106,283,0,389
2015,Abril,Azerbaiyán,1,2,0,3
2015,Abril,Bahamas,4,10,0,14
2015,Abril,Bahréin,0,2,0,2
2015,Abril,Bangladesh,1,3,0,4
2015,Abril,Barbados,4,18,0,22
2015,Abril,República de Belarús,5,3,0,8
2015,Abril,Bélgica,166,383,0,549
2015,Abril,Belice,3,17,0,20
2015,Abril,Bermudas/Territorio Británico de Ultramar,0,1,0,1
2015,Abril,Bolivia,397,564,0,961
2015,Abril,Bosnia y Herzegovina,0,1,0,1
2015,Abril,Brasil,5277,6107,0,11384
2015,Abril,Brunei Darussalam,1,0,0,1
2015,Abril,Bulgaria,28,42,0,70
2015,Abril,Burkina Faso,0,1,0,1
2015,Abril,Burundi,0,1,0,1
2015,Abril,Islas Caimán/Territorio Británico de Ultramar,0,2,0,2
2015,Abril,Camboya,0,2,0,2
2015,Abril,Camerún,2,2,0,4
2015,Abril,Canadá,968,1664,0,2632
2015,Abril,España,2446,5910,0,8356
2015,Abril,República Democrática del Congo,1,2,0,3
2015,Abril,República de Corea,275,795,0,1070
2015,Abril,Costa de Marfil,0,2,0,2
2015,Abril,Costa Rica,941,1494,0,2435
2015,Abril,Croacia,16,45,0,61
2015,Abril,Cuba,330,480,0,810
2015,Abril,República Checa,66,70,0,136
2015,Abril,Chile,3667,4806,0,8473
2015,Abril,China,266,794,0,1060
2015,Abril,Chipre,5,2,0,7
2015,Abril,Dinamarca,86,176,0,262
2015,Abril,Dominica,0,3,0,3
2015,Abril,Ecuador,5214,7085,0,12299
2015,Abril,Egipto,5,20,0,25
2015,Abril,El Salvador,770,1011,0,1781
2015,Abril,Emiratos Árabes,1,0,0,1
2015,Abril,Eritrea,0,2,0,2
2015,Abril,Eslovaquia,24,25,0,49
2015,Abril,Eslovenia,21,30,0,51
2015,Abril,Estados Unidos de América,9950,18769,0,28719
2015,Abril,Estonia,9,26,0,35
2015,Abril,Etiopia,1,2,0,3
2015,Abril,Filipinas,35,183,0,218
2015,Abril,Finlandia,50,85,0,135
2015,Abril,Francia,1433,2453,0,3886
2015,Abril,Georgia,3,2,0,5
2015,Abril,Ghana,0,3,0,3
2015,Abril,Granada,3,5,0,8
2015,Abril,Grecia,26,81,0,107
2015,Abril,Guatemala,365,839,0,1204
2015,Abril,Guyana,7,15,0,22
2015,Abril,Guinea,1,0,0,1
2015,Abril,Haití,3,19,0,22
2015,Abril,Honduras,231,367,0,598
2015,Abril,Hong Kong,3,0,0,3
2015,Abril,Hungría,15,32,0,47
2015,Abril,India,54,408,0,462
2015,Abril,Indonesia,12,24,0,36
2015,Abril,Iraq,0,1,0,1
2015,Abril,Irán,3,22,0,25
2015,Abril,República de Irlanda,103,221,0,324
2015,Abril,Islandia,4,13,0,17
2015,Abril,Israel,318,1157,0,1475
2015,Abril,Italia,626,1956,0,2582
2015,Abril,Jamaica,9,25,0,34
2015,Abril,Japón,144,476,0,620
2015,Abril,Jordania,2,5,0,7
2015,Abril,Kazajistán,4,0,0,4
2015,Abril,Kenia,12,32,0,44
2015,Abril,Kiribati,0,3,0,3
2015,Abril,Kuwait,0,9,0,9
2015,Abril,Letonia,11,7,0,18
2015,Abril,Lituania,15,21,0,36
2015,Abril,Líbano,12,23,0,35
2015,Abril,Liechtenstein,3,3,0,6
2015,Abril,Luxemburgo,6,12,0,18
2015,Abril,Macedonia,1,1,0,2
2015,Abril,Madagascar,4,0,0,4
2015,Abril,Malasia,18,39,0,57
2015,Abril,Malawi,0,1,0,1
2015,Abril,Malí,0,1,0,1
2015,Abril,Malta,2,12,0,14
2015,Abril,Marruecos,7,13,0,20
2015,Abril,Mauricio,0,3,0,3
2015,Abril,México,4231,8055,0,12286
2015,Abril,República de Moldavia,3,1,0,4
2015,Abril,Mongolia,1,0,0,1
2015,Abril,Montenegro,2,2,0,4
2015,Abril,Mozambique,1,2,0,3
2015,Abril,Myanmar,1,3,0,4
2015,Abril,Namibia,0,1,0,1
2015,Abril,Nepal,1,2,0,3
2015,Abril,Nicaragua,80,128,0,208
2015,Abril,Nigeria,0,7,0,7
2015,Abril,Noruega,99,142,0,241
2015,Abril,Nueva Zelanda,61,112,0,173
2015,Abril,Pakistán,1,17,0,18
2015,Abril,Panamá,1798,2366,0,4164
2015,Abril,Paraguay,324,253,0,577
2015,Abril,Perú,4712,5891,0,10603
2015,Abril,Palestina,0,3,0,3
2015,Abril,Polonia,132,188,0,320
2015,Abril,Portugal,308,664,0,972
2015,Abril,Qatar,0,2,0,2
2015,Abril,Reino Unido de Gran Bretaña e Irlanda del Norte,985,1941,0,2926
2015,Abril,Federación de Rusia,158,218,0,376
2015,Abril,República Dominicana,419,579,0,998
2015,Abril,Rumania,61,94,0,155
2015,Abril,Rwanda,0,2,0,2
2015,Abril,San Cristóbal y Nevis,1,1,0,2
2015,Abril,San Marino,0,1,0,1
2015,Abril,San  Vicente y las Granadinas,0,2,0,2
2015,Abril,Santa Lucia,4,9,0,13
2015,Abril,Santa Sede/Ciudad del Vaticano,0,1,0,1
2015,Abril,Senegal,1,3,0,4
2015,Abril,Serbia,6,6,0,12
2015,Abril,Singapur,13,17,0,30
2015,Abril,República Árabe Siria,1,1,0,2
2015,Abril,Sri Lanka,2,5,0,7
2015,Abril,Sudáfrica,35,91,0,126
2015,Abril,Sudán,0,1,0,1
2015,Abril,Suecia,190,287,0,477
2015,Abril,Suiza,423,714,0,1137
2015,Abril,Surinam,10,20,0,30
2015,Abril,Taiwán,55,84,0,139
2015,Abril,Tailandia,10,9,0,19
2015,Abril,Tanzania,0,2,0,2
2015,Abril,Togo,0,1,0,1
2015,Abril,Trinidad y Tobago,33,91,0,124
2015,Abril,Túnez,3,5,0,8
2015,Abril,Turquía,35,129,0,164
2015,Abril,Ucrania,32,42,0,74
2015,Abril,Uganda,3,2,0,5
2015,Abril,Uruguay,329,525,0,854
2015,Abril,Uzbekistán,2,0,0,2
2015,Abril,Venezuela,11142,14216,0,25358
2015,Abril,Vietnam,1,2,0,3
2015,Abril,República Árabe de Yemen,2,1,0,3
2015,Abril,Zambia,0,2,0,2
2015,Abril,Zimbabue,1,2,0,3
2015,Abril,Islas Turcas y Caicos/Territorio Británico de Ultramar,0,2,0,2
2015,Abril,Desconocido,78,135,0,213
2015,Mayo,Afganistán,0,1,0,1
2015,Mayo,Albania,0,4,0,4
2015,Mayo,Alemania,1455,2342,0,3797
2015,Mayo,Andorra,1,7,0,8
2015,Mayo,Angola,1,4,0,5
2015,Mayo,Antigua y Barbuda,3,9,0,12
2015,Mayo,Países Bajos,1238,1922,0,3160
2015,Mayo,Arabia Saudita,1,15,0,16
2015,Mayo,Argelia,1,9,0,10
2015,Mayo,Argentina,4773,6021,0,10794
2015,Mayo,República de Armenia,1,4,0,5
2015,Mayo,Aruba,1,4,0,5
2015,Mayo,Australia,394,734,0,1128
2015,Mayo,Austria,132,250,0,382
2015,Mayo,Azerbaiyán,3,3,0,6
2015,Mayo,Bahamas,4,8,0,12
2015,Mayo,Bahréin,0,1,0,1
2015,Mayo,Bangladesh,0,6,0,6
2015,Mayo,Barbados,2,8,0,10
2015,Mayo,República de Belarús,3,7,0,10
2015,Mayo,Bélgica,144,385,0,529
2015,Mayo,Belice,3,20,0,23
2015,Mayo,Bermudas/Territorio Británico de Ultramar,1,5,0,6
2015,Mayo,Bolivia,482,576,0,1058
2015,Mayo,Bosnia y Herzegovina,0,1,0,1
2015,Mayo,Brasil,4735,6318,0,11053
2015,Mayo,Brunei Darussalam,1,0,0,1
2015,Mayo,Bulgaria,17,34,0,51
2015,Mayo,Burkina Faso,1,0,0,1
2015,Mayo,Burundi,1,0,0,1
2015,Mayo,Bután,0,1,0,1
2015,Mayo,Islas Caimán/Territorio Británico de Ultramar,3,5,0,8
2015,Mayo,Camboya,1,2,0,3
2015,Mayo,Camerún,1,2,0,3
2015,Mayo,Canadá,902,1598,0,2500
2015,Mayo,España,2505,6183,0,8688
2015,Mayo,República de Corea,215,500,0,715
2015,Mayo,Costa de Marfil,0,1,0,1
2015,Mayo,Costa Rica,970,1518,0,2488
2015,Mayo,Croacia,7,45,0,52
2015,Mayo,Cuba,351,577,0,928
2015,Mayo,República Checa,41,61,0,102
2015,Mayo,Chile,4573,5682,0,10255
2015,Mayo,China,441,1138,0,1579
2015,Mayo,Chipre,1,7,0,8
2015,Mayo,Dinamarca,111,194,0,305
2015,Mayo,Dominica,3,5,0,8
2015,Mayo,Ecuador,4163,6922,0,11085
2015,Mayo,Egipto,7,30,0,37
2015,Mayo,El Salvador,748,1007,0,1755
2015,Mayo,Emiratos Árabes,0,10,0,10
2015,Mayo,Eritrea,0,1,0,1
2015,Mayo,Eslovaquia,18,16,0,34
2015,Mayo,Eslovenia,8,17,0,25
2015,Mayo,Estados Unidos de América,11596,21176,0,32772
2015,Mayo,Estonia,6,10,0,16
2015,Mayo,Etiopia,3,0,0,3
2015,Mayo,Filipinas,35,228,0,263
2015,Mayo,Finlandia,49,98,0,147
2015,Mayo,Francia,1248,2311,0,3559
2015,Mayo,Georgia,1,6,0,7
2015,Mayo,Ghana,1,9,0,10
2015,Mayo,Granada,3,5,0,8
2015,Mayo,Grecia,17,69,0,86
2015,Mayo,Guatemala,441,949,0,1390
2015,Mayo,Guyana,8,14,0,22
2015,Mayo,Guinea,0,1,0,1
2015,Mayo,Guinea Bissau,0,1,0,1
2015,Mayo,Haití,5,15,0,20
2015,Mayo,Honduras,238,342,0,580
2015,Mayo,Hong Kong,3,2,0,5
2015,Mayo,Hungría,18,44,0,62
2015,Mayo,India,70,503,0,573
2015,Mayo,Indonesia,7,39,0,46
2015,Mayo,Irán,4,19,0,23
2015,Mayo,República de Irlanda,107,200,0,307
2015,Mayo,Islandia,8,5,0,13
2015,Mayo,Israel,345,1015,0,1360
2015,Mayo,Italia,574,2011,0,2585
2015,Mayo,Jamaica,23,39,0,62
2015,Mayo,Japón,147,568,0,715
2015,Mayo,Jordania,2,4,0,6
2015,Mayo,Kazajistán,10,4,0,14
2015,Mayo,Kenia,3,8,0,11
2015,Mayo,Kiribati,0,4,0,4
2015,Mayo,Kirguistán,0,1,0,1
2015,Mayo,Kuwait,1,5,0,6
2015,Mayo,República de Kosovo,0,3,0,3
2015,Mayo,Letonia,5,13,0,18
2015,Mayo,Lituania,19,17,0,36
2015,Mayo,Líbano,20,28,0,48
2015,Mayo,Liechtenstein,2,1,0,3
2015,Mayo,Luxemburgo,4,8,0,12
2015,Mayo,Macedonia,0,3,0,3
2015,Mayo,Madagascar,1,0,0,1
2015,Mayo,Malasia,8,23,0,31
2015,Mayo,Malta,0,5,0,5
2015,Mayo,Marruecos,8,9,0,17
2015,Mayo,Mauricio,0,1,0,1
2015,Mayo,México,4368,7988,0,12356
2015,Mayo,República de Moldavia,2,0,0,2
2015,Mayo,Mónaco,1,0,0,1
2015,Mayo,Mongolia,3,2,0,5
2015,Mayo,Montenegro,1,3,0,4
2015,Mayo,Mozambique,1,1,0,2
2015,Mayo,Myanmar,1,0,0,1
2015,Mayo,Nepal,1,3,0,4
2015,Mayo,Nicaragua,91,140,0,231
2015,Mayo,Nigeria,1,14,0,15
2015,Mayo,Noruega,69,115,0,184
2015,Mayo,Nueva Zelanda,64,128,0,192
2015,Mayo,Pakistán,2,14,0,16
2015,Mayo,Panamá,1930,2533,0,4463
2015,Mayo,Paraguay,420,431,0,851
2015,Mayo,Perú,5299,6066,0,11365
2015,Mayo,Palestina,1,5,0,6
2015,Mayo,Polonia,159,213,0,372
2015,Mayo,Portugal,231,611,0,842
2015,Mayo,Qatar,0,3,0,3
2015,Mayo,Reino Unido de Gran Bretaña e Irlanda del Norte,984,2257,0,3241
2015,Mayo,Federación de Rusia,179,244,0,423
2015,Mayo,República Dominicana,473,653,0,1126
2015,Mayo,República Democrática Popular de Corea,1,1,0,2
2015,Mayo,Rumania,57,75,0,132
2015,Mayo,Rwanda,0,2,0,2
2015,Mayo,San Cristóbal y Nevis,2,2,0,4
2015,Mayo,San Marino,1,2,0,3
2015,Mayo,San  Vicente y las Granadinas,0,4,0,4
2015,Mayo,Santa Lucia,4,4,0,8
2015,Mayo,Santa Sede/Ciudad del Vaticano,0,2,0,2
2015,Mayo,Senegal,0,2,0,2
2015,Mayo,Serbia,5,13,0,18
2015,Mayo,Singapur,12,24,0,36
2015,Mayo,República Árabe Siria,0,5,0,5
2015,Mayo,Sri Lanka,0,5,0,5
2015,Mayo,Sudáfrica,58,103,0,161
2015,Mayo,Sudán,0,2,0,2
2015,Mayo,Suecia,162,258,0,420
2015,Mayo,Suiza,349,627,0,976
2015,Mayo,Surinam,22,30,0,52
2015,Mayo,Suazilandia,0,1,0,1
2015,Mayo,Taiwán,67,98,0,165
2015,Mayo,República de Tayikistán,1,3,0,4
2015,Mayo,Tailandia,7,6,0,13
2015,Mayo,Tanzania,1,0,0,1
2015,Mayo,Trinidad y Tobago,47,73,0,120
2015,Mayo,Túnez,0,5,0,5
2015,Mayo,Turquía,20,112,0,132
2015,Mayo,Ucrania,20,46,0,66
2015,Mayo,Uganda,1,5,0,6
2015,Mayo,Uruguay,385,633,0,1018
2015,Mayo,Uzbekistán,3,0,0,3
2015,Mayo,Venezuela,10836,14379,0,25215
2015,Mayo,Vietnam,11,13,0,24
2015,Mayo,Zambia,6,4,0,10
2015,Mayo,Zimbabue,5,4,0,9
2015,Mayo,Desconocido,64,135,0,199
2015,Junio,Afganistán,3,5,0,8
2015,Junio,Albania,2,8,0,10
2015,Junio,Alemania,1413,2328,0,3741
2015,Junio,Andorra,1,10,0,11
2015,Junio,Angola,0,1,0,1
2015,Junio,Antigua y Barbuda,4,11,0,15
2015,Junio,Países Bajos,1039,1738,0,2777
2015,Junio,Arabia Saudita,1,8,0,9
2015,Junio,Argelia,2,8,0,10
2015,Junio,Argentina,3537,5205,0,8742
2015,Junio,República de Armenia,0,3,0,3
2015,Junio,Australia,401,614,0,1015
2015,Junio,Austria,125,219,0,344
2015,Junio,Azerbaiyán,2,6,0,8
2015,Junio,Bahamas,15,22,0,37
2015,Junio,Bahréin,1,4,0,5
2015,Junio,Bangladesh,0,2,0,2
2015,Junio,Barbados,3,18,0,21
2015,Junio,República de Belarús,5,3,0,8
2015,Junio,Bélgica,249,465,0,714
2015,Junio,Belice,10,10,0,20
2015,Junio,Benín,1,3,0,4
2015,Junio,Bermudas/Territorio Británico de Ultramar,1,0,0,1
2015,Junio,Bolivia,638,691,0,1329
2015,Junio,Bosnia y Herzegovina,0,3,0,3
2015,Junio,Botsuana,2,1,0,3
2015,Junio,Brasil,3975,5448,0,9423
2015,Junio,Brunei Darussalam,0,2,0,2
2015,Junio,Bulgaria,27,25,0,52
2015,Junio,Cabo Verde,0,1,0,1
2015,Junio,Islas Caimán/Territorio Británico de Ultramar,0,1,0,1
2015,Junio,Camerún,2,5,0,7
2015,Junio,Canadá,1067,1752,0,2819
2015,Junio,España,2883,6580,0,9463
2015,Junio,República Democrática del Congo,1,1,0,2
2015,Junio,República de Corea,213,462,0,675
2015,Junio,Costa de Marfil,1,2,0,3
2015,Junio,Costa Rica,863,1316,0,2179
2015,Junio,Croacia,12,50,0,62
2015,Junio,Cuba,504,702,0,1206
2015,Junio,República Checa,61,64,0,125
2015,Junio,Chile,2792,4144,0,6936
2015,Junio,China,320,758,0,1078
2015,Junio,Chipre,5,7,0,12
2015,Junio,Dinamarca,107,196,0,303
2015,Junio,Dominica,0,3,0,3
2015,Junio,Ecuador,3861,6100,0,9961
2015,Junio,Egipto,6,22,0,28
2015,Junio,El Salvador,683,999,0,1682
2015,Junio,Emiratos Árabes,2,5,0,7
2015,Junio,Eritrea,0,3,0,3
2015,Junio,Eslovaquia,32,23,0,55
2015,Junio,Eslovenia,8,26,0,34
2015,Junio,Estados Unidos de América,18623,27104,0,45727
2015,Junio,Estonia,13,18,0,31
2015,Junio,Etiopia,2,5,0,7
2015,Junio,Islas Fiji,1,0,0,1
2015,Junio,Filipinas,42,239,0,281
2015,Junio,Finlandia,63,78,0,141
2015,Junio,Francia,1483,2612,0,4095
2015,Junio,Gabón,0,1,0,1
2015,Junio,Georgia,8,10,0,18
2015,Junio,Ghana,2,7,0,9
2015,Junio,Granada,1,4,0,5
2015,Junio,Grecia,20,72,0,92
2015,Junio,Guatemala,532,987,0,1519
2015,Junio,Guyana,8,14,0,22
2015,Junio,Guinea,0,2,0,2
2015,Junio,Haití,10,30,0,40
2015,Junio,Honduras,220,345,0,565
2015,Junio,Hong Kong,2,3,0,5
2015,Junio,Hungría,23,31,0,54
2015,Junio,India,76,431,0,507
2015,Junio,Indonesia,22,41,0,63
2015,Junio,Irán,4,15,0,19
2015,Junio,República de Irlanda,155,232,0,387
2015,Junio,Islandia,6,7,0,13
2015,Junio,Israel,259,840,0,1099
2015,Junio,Italia,719,2003,0,2722
2015,Junio,Jamaica,45,82,0,127
2015,Junio,Japón,160,528,0,688
2015,Junio,Jordania,0,3,0,3
2015,Junio,Kazajistán,6,5,0,11
2015,Junio,Kenia,17,23,0,40
2015,Junio,Kuwait,0,6,0,6
2015,Junio,Lesoto,2,0,0,2
2015,Junio,Letonia,7,32,0,39
2015,Junio,Lituania,22,24,0,46
2015,Junio,Líbano,29,36,0,65
2015,Junio,Libia,0,1,0,1
2015,Junio,Liechtenstein,2,2,0,4
2015,Junio,Luxemburgo,2,2,0,4
2015,Junio,Macedonia,0,2,0,2
2015,Junio,Malasia,16,27,0,43
2015,Junio,Malawi,0,1,0,1
2015,Junio,Malí,0,1,0,1
2015,Junio,Malta,1,7,0,8
2015,Junio,Marruecos,14,8,0,22
2015,Junio,Mauricio,4,3,0,7
2015,Junio,Mauritania,1,0,0,1
2015,Junio,México,4718,8483,0,13201
2015,Junio,República de Moldavia,4,1,0,5
2015,Junio,Mónaco,0,1,0,1
2015,Junio,Mongolia,2,2,0,4
2015,Junio,Montenegro,0,2,0,2
2015,Junio,Mozambique,0,1,0,1
2015,Junio,Myanmar,0,3,0,3
2015,Junio,Nepal,1,9,0,10
2015,Junio,Nicaragua,92,104,0,196
2015,Junio,Nigeria,2,9,0,11
2015,Junio,Noruega,153,257,0,410
2015,Junio,Nueva Zelanda,80,135,0,215
2015,Junio,Omán,0,2,0,2
2015,Junio,Pakistán,0,17,0,17
2015,Junio,Panamá,1706,2304,0,4010
2015,Junio,Paraguay,437,345,0,782
2015,Junio,Perú,4064,5242,0,9306
2015,Junio,Palestina,2,3,0,5
2015,Junio,Polonia,101,149,0,250
2015,Junio,Portugal,240,557,0,797
2015,Junio,Qatar,0,3,0,3
2015,Junio,Reino Unido de Gran Bretaña e Irlanda del Norte,1105,2183,0,3288
2015,Junio,República CentroÁfricana,0,1,0,1
2015,Junio,Federación de Rusia,149,202,0,351
2015,Junio,República Dominicana,474,739,0,1213
2015,Junio,Rumania,44,96,0,140
2015,Junio,Rwanda,0,1,0,1
2015,Junio,San Cristóbal y Nevis,1,5,0,6
2015,Junio,Samoa Occidental,1,0,0,1
2015,Junio,San  Vicente y las Granadinas,2,4,0,6
2015,Junio,Santa Lucia,5,2,0,7
2015,Junio,Santa Sede/Ciudad del Vaticano,0,1,0,1
2015,Junio,Senegal,4,7,0,11
2015,Junio,Serbia,7,15,0,22
2015,Junio,Seychelles,0,2,0,2
2015,Junio,Sierra Leona,0,1,0,1
2015,Junio,Singapur,26,35,0,61
2015,Junio,República Árabe Siria,1,4,0,5
2015,Junio,Sri Lanka,1,3,0,4
2015,Junio,Sudáfrica,48,107,0,155
2015,Junio,Sudán,0,2,0,2
2015,Junio,Suecia,223,344,0,567
2015,Junio,Suiza,406,682,0,1088
2015,Junio,Surinam,23,19,0,42
2015,Junio,Taiwán,67,95,0,162
2015,Junio,Tailandia,32,24,0,56
2015,Junio,Tanzania,5,5,0,10
2015,Junio,Togo,0,2,0,2
2015,Junio,Trinidad y Tobago,33,99,0,132
2015,Junio,Túnez,1,6,0,7
2015,Junio,Turquía,29,101,0,130
2015,Junio,Ucrania,20,34,0,54
2015,Junio,Uganda,6,4,0,10
2015,Junio,Uruguay,412,578,0,990
2015,Junio,Uzbekistán,1,0,0,1
2015,Junio,Venezuela,10547,13504,0,24051
2015,Junio,Vietnam,4,13,0,17
2015,Junio,República Árabe de Yemen,0,1,0,1
2015,Junio,Zambia,2,3,0,5
2015,Junio,Zimbabue,1,1,0,2
2015,Junio,Desconocido,53,137,0,190
2015,Julio,Afganistán,0,1,0,1
2015,Julio,Albania,2,6,0,8
2015,Julio,Alemania,2297,2958,0,5255
2015,Julio,Andorra,0,9,0,9
2015,Julio,Angola,1,4,0,5
2015,Julio,Antigua y Barbuda,3,16,0,19
2015,Julio,Países Bajos,2254,2920,0,5174
2015,Julio,Arabia Saudita,2,18,0,20
2015,Julio,Argelia,1,20,0,21
2015,Julio,Argentina,4579,5777,0,10356
2015,Julio,República de Armenia,1,2,0,3
2015,Julio,Aruba,1,4,0,5
2015,Julio,Australia,475,785,0,1260
2015,Julio,Austria,299,377,0,676
2015,Julio,Azerbaiyán,2,6,0,8
2015,Julio,Bahamas,19,25,0,44
2015,Julio,Bahréin,6,7,0,13
2015,Julio,Bangladesh,0,1,0,1
2015,Julio,Barbados,21,26,0,47
2015,Julio,República de Belarús,4,12,0,16
2015,Julio,Bélgica,497,683,0,1180
2015,Julio,Belice,11,18,0,29
2015,Julio,Benín,0,2,0,2
2015,Julio,Bermudas/Territorio Británico de Ultramar,3,7,0,10
2015,Julio,Bolivia,661,711,0,1372
2015,Julio,Bosnia y Herzegovina,2,2,0,4
2015,Julio,Botsuana,1,5,0,6
2015,Julio,Brasil,5191,6239,0,11430
2015,Julio,Bulgaria,20,31,0,51
2015,Julio,Burkina Faso,1,1,0,2
2015,Julio,Islas Caimán/Territorio Británico de Ultramar,9,9,0,18
2015,Julio,Camboya,1,0,0,1
2015,Julio,Camerún,2,3,0,5
2015,Julio,Canadá,1361,2013,0,3374
2015,Julio,Chad,0,2,0,2
2015,Julio,España,3519,7033,0,10552
2015,Julio,Comoras,0,1,0,1
2015,Julio,República Democrática del Congo,0,5,0,5
2015,Julio,República de Corea,304,550,0,854
2015,Julio,Costa de Marfil,1,3,0,4
2015,Julio,Costa Rica,1217,1678,0,2895
2015,Julio,Croacia,7,52,0,59
2015,Julio,Cuba,258,421,0,679
2015,Julio,República Checa,47,92,0,139
2015,Julio,Chile,4313,5159,0,9472
2015,Julio,China,430,903,0,1333
2015,Julio,Chipre,3,10,0,13
2015,Julio,Dinamarca,191,279,0,470
2015,Julio,Dominica,4,6,0,10
2015,Julio,Ecuador,5836,7674,0,13510
2015,Julio,Egipto,17,37,0,54
2015,Julio,El Salvador,815,1026,0,1841
2015,Julio,Emiratos Árabes,7,22,0,29
2015,Julio,Eslovaquia,33,30,0,63
2015,Julio,Eslovenia,23,37,0,60
2015,Julio,Estados Unidos de América,19243,28278,0,47521
2015,Julio,Estonia,9,18,0,27
2015,Julio,Etiopia,15,18,0,33
2015,Julio,Islas Fiji,0,1,0,1
2015,Julio,Filipinas,40,199,0,239
2015,Julio,Finlandia,74,59,0,133
2015,Julio,Francia,2681,3863,0,6544
2015,Julio,Gabón,0,1,0,1
2015,Julio,Georgia,4,7,0,11
2015,Julio,Ghana,3,20,0,23
2015,Julio,Granada,2,6,0,8
2015,Julio,Grecia,56,92,0,148
2015,Julio,Guatemala,539,1097,0,1636
2015,Julio,Guyana,6,18,0,24
2015,Julio,Guinea Ecuatorial,1,1,0,2
2015,Julio,Guinea Bissau,0,2,0,2
2015,Julio,Haití,9,26,0,35
2015,Julio,Honduras,292,428,0,720
2015,Julio,Hong Kong,5,2,0,7
2015,Julio,Hungría,43,63,0,106
2015,Julio,India,82,449,0,531
2015,Julio,Indonesia,21,36,0,57
2015,Julio,Iraq,1,8,0,9
2015,Julio,Irán,9,18,0,27
2015,Julio,República de Irlanda,196,285,0,481
2015,Julio,Islandia,6,6,0,12
2015,Julio,Israel,216,799,0,1015
2015,Julio,Italia,935,2319,0,3254
2015,Julio,Jamaica,54,74,0,128
2015,Julio,Japón,183,608,0,791
2015,Julio,Jordania,3,2,0,5
2015,Julio,Kazajistán,12,2,0,14
2015,Julio,Kenia,21,47,0,68
2015,Julio,Kiribati,0,1,0,1
2015,Julio,Kirguistán,2,0,0,2
2015,Julio,Kuwait,1,3,0,4
2015,Julio,República de Kosovo,0,1,0,1
2015,Julio,Lesoto,1,2,0,3
2015,Julio,Letonia,20,23,0,43
2015,Julio,Lituania,24,18,0,42
2015,Julio,Líbano,18,32,0,50
2015,Julio,Liberia,0,1,0,1
2015,Julio,Libia,0,1,0,1
2015,Julio,Liechtenstein,6,1,0,7
2015,Julio,Luxemburgo,13,9,0,22
2015,Julio,Macedonia,4,5,0,9
2015,Julio,Madagascar,1,0,0,1
2015,Julio,Malasia,22,36,0,58
2015,Julio,Malta,4,4,0,8
2015,Julio,Marruecos,6,26,0,32
2015,Julio,Mauricio,2,6,0,8
2015,Julio,México,6424,10046,0,16470
2015,Julio,República de Moldavia,4,3,0,7
2015,Julio,Mónaco,0,1,0,1
2015,Julio,Mongolia,0,1,0,1
2015,Julio,Montenegro,2,2,0,4
2015,Julio,Montserrat/Territorio Británico de Ultramar,1,0,0,1
2015,Julio,Micronesia,0,1,0,1
2015,Julio,Mozambique,0,2,0,2
2015,Julio,Namibia,1,4,0,5
2015,Julio,Nepal,2,8,0,10
2015,Julio,Nicaragua,72,137,0,209
2015,Julio,Nigeria,4,15,0,19
2015,Julio,Noruega,219,258,0,477
2015,Julio,Nueva Zelanda,116,164,0,280
2015,Julio,Omán,0,5,0,5
2015,Julio,Papúa Nueva Guinea,0,1,0,1
2015,Julio,Pakistán,4,13,0,17
2015,Julio,Panamá,2047,2633,0,4680
2015,Julio,Paraguay,167,157,0,324
2015,Julio,Perú,6018,6942,0,12960
2015,Julio,Palestina,2,1,0,3
2015,Julio,Polonia,117,184,0,301
2015,Julio,Portugal,286,677,0,963
2015,Julio,Puerto Rico/Territorio de Estados Unidos,1,1,0,2
2015,Julio,Qatar,0,5,0,5
2015,Julio,Reino Unido de Gran Bretaña e Irlanda del Norte,1619,2808,0,4427
2015,Julio,República CentroÁfricana,1,0,0,1
2015,Julio,Federación de Rusia,173,213,0,386
2015,Julio,República Dominicana,494,809,0,1303
2015,Julio,Rumania,65,86,0,151
2015,Julio,Rwanda,2,1,0,3
2015,Julio,San Cristóbal y Nevis,6,9,0,15
2015,Julio,San Marino,2,1,0,3
2015,Julio,San  Vicente y las Granadinas,4,2,0,6
2015,Julio,Santa Lucia,6,6,0,12
2015,Julio,Senegal,4,5,0,9
2015,Julio,Serbia,15,18,0,33
2015,Julio,Seychelles,0,1,0,1
2015,Julio,Sierra Leona,0,1,0,1
2015,Julio,Singapur,13,38,0,51
2015,Julio,República Árabe Siria,0,4,0,4
2015,Julio,Somalia,0,1,0,1
2015,Julio,Sri Lanka,4,7,0,11
2015,Julio,Sudáfrica,78,121,0,199
2015,Julio,Sudán,2,10,0,12
2015,Julio,Suecia,244,360,0,604
2015,Julio,Suiza,923,1294,0,2217
2015,Julio,Surinam,21,26,0,47
2015,Julio,Suazilandia,0,3,0,3
2015,Julio,Taiwán,78,84,0,162
2015,Julio,República de Tayikistán,1,1,0,2
2015,Julio,Tailandia,8,8,0,16
2015,Julio,Togo,0,1,0,1
2015,Julio,Trinidad y Tobago,86,109,0,195
2015,Julio,Túnez,2,17,0,19
2015,Julio,Turquía,54,186,0,240
2015,Julio,Ucrania,41,57,0,98
2015,Julio,Uganda,2,5,0,7
2015,Julio,Uruguay,330,580,0,910
2015,Julio,Uzbekistán,5,7,0,12
2015,Julio,Venezuela,15020,17185,0,32205
2015,Julio,Vietnam,6,4,0,10
2015,Julio,República Árabe de Yemen,0,1,0,1
2015,Julio,Zambia,0,3,0,3
2015,Julio,Zimbabue,3,4,0,7
2015,Julio,Islas Turcas y Caicos/Territorio Británico de Ultramar,1,0,0,1
2015,Julio,Desconocido,43,111,0,154
2015,Agosto,Afganistán,0,1,0,1
2015,Agosto,Albania,2,6,0,8
2015,Agosto,Alemania,2599,3218,0,5817
2015,Agosto,Andorra,3,10,0,13
2015,Agosto,Angola,0,1,0,1
2015,Agosto,Antigua y Barbuda,1,10,0,11
2015,Agosto,Países Bajos,1297,1987,0,3284
2015,Agosto,Arabia Saudita,0,11,0,11
2015,Agosto,Argelia,3,10,0,13
2015,Agosto,Argentina,4203,5839,0,10042
2015,Agosto,República de Armenia,2,2,0,4
2015,Agosto,Aruba,2,0,0,2
2015,Agosto,Australia,413,650,0,1063
2015,Agosto,Austria,228,320,0,548
2015,Agosto,Azerbaiyán,0,3,0,3
2015,Agosto,Bahamas,12,12,0,24
2015,Agosto,Bahréin,0,3,0,3
2015,Agosto,Bangladesh,1,4,0,5
2015,Agosto,Barbados,10,9,0,19
2015,Agosto,República de Belarús,7,4,0,11
2015,Agosto,Bélgica,275,471,0,746
2015,Agosto,Belice,10,27,0,37
2015,Agosto,Benín,0,2,0,2
2015,Agosto,Bermudas/Territorio Británico de Ultramar,5,1,0,6
2015,Agosto,Bolivia,638,737,0,1375
2015,Agosto,Bosnia y Herzegovina,0,1,0,1
2015,Agosto,Botsuana,1,1,0,2
2015,Agosto,Brasil,4061,5929,0,9990
2015,Agosto,Bulgaria,21,23,0,44
2015,Agosto,Islas Caimán/Territorio Británico de Ultramar,3,5,0,8
2015,Agosto,Camboya,1,3,0,4
2015,Agosto,Camerún,0,7,0,7
2015,Agosto,Canadá,1167,1833,0,3000
2015,Agosto,Chad,0,1,0,1
2015,Agosto,España,4089,7176,0,11265
2015,Agosto,República Democrática del Congo,1,2,0,3
2015,Agosto,República de Corea,260,564,0,824
2015,Agosto,Costa de Marfil,0,3,0,3
2015,Agosto,Costa Rica,958,1437,0,2395
2015,Agosto,Croacia,18,46,0,64
2015,Agosto,Cuba,273,475,0,748
2015,Agosto,República Checa,31,59,0,90
2015,Agosto,Chile,4391,5699,0,10090
2015,Agosto,China,421,959,0,1380
2015,Agosto,Chipre,6,10,0,16
2015,Agosto,Dinamarca,77,145,0,222
2015,Agosto,Dominica,0,9,0,9
2015,Agosto,Ecuador,7444,9366,0,16810
2015,Agosto,Egipto,12,27,0,39
2015,Agosto,El Salvador,1149,1259,0,2408
2015,Agosto,Emiratos Árabes,1,8,0,9
2015,Agosto,Eslovaquia,18,20,0,38
2015,Agosto,Eslovenia,13,31,0,44
2015,Agosto,Estados Unidos de América,15117,25259,0,40376
2015,Agosto,Estonia,5,6,0,11
2015,Agosto,Etiopia,1,1,0,2
2015,Agosto,Islas Fiji,0,2,0,2
2015,Agosto,Filipinas,50,264,0,314
2015,Agosto,Finlandia,44,50,0,94
2015,Agosto,Francia,2166,3410,0,5576
2015,Agosto,Gabón,0,1,0,1
2015,Agosto,Georgia,2,3,0,5
2015,Agosto,Ghana,2,14,0,16
2015,Agosto,Granada,1,5,0,6
2015,Agosto,Grecia,45,79,0,124
2015,Agosto,Guatemala,534,1060,0,1594
2015,Agosto,Guyana,12,17,0,29
2015,Agosto,Guinea,0,1,0,1
2015,Agosto,Guinea Ecuatorial,0,1,0,1
2015,Agosto,Haití,5,14,0,19
2015,Agosto,Honduras,257,432,0,689
2015,Agosto,Hong Kong,2,3,0,5
2015,Agosto,Hungría,31,29,0,60
2015,Agosto,India,90,584,0,674
2015,Agosto,Indonesia,18,37,0,55
2015,Agosto,Irán,4,20,0,24
2015,Agosto,República de Irlanda,159,252,0,411
2015,Agosto,Islandia,3,8,0,11
2015,Agosto,Israel,226,771,0,997
2015,Agosto,Italia,1274,3093,0,4367
2015,Agosto,Jamaica,28,43,0,71
2015,Agosto,Japón,217,549,0,766
2015,Agosto,Jordania,0,10,0,10
2015,Agosto,Kazajistán,7,6,0,13
2015,Agosto,Kenia,4,20,0,24
2015,Agosto,Kirguistán,1,1,0,2
2015,Agosto,Kuwait,1,6,0,7
2015,Agosto,República de Kosovo,1,0,0,1
2015,Agosto,República Democrática Popular  Lao,0,1,0,1
2015,Agosto,Lesoto,1,0,0,1
2015,Agosto,Letonia,11,10,0,21
2015,Agosto,Lituania,21,24,0,45
2015,Agosto,Líbano,26,41,0,67
2015,Agosto,Liechtenstein,0,3,0,3
2015,Agosto,Luxemburgo,13,17,0,30
2015,Agosto,Macedonia,0,1,0,1
2015,Agosto,Madagascar,1,0,0,1
2015,Agosto,Malasia,23,46,0,69
2015,Agosto,Malawi,3,5,0,8
2015,Agosto,Malí,0,2,0,2
2015,Agosto,Malta,5,7,0,12
2015,Agosto,Marruecos,4,13,0,17
2015,Agosto,Mauricio,0,1,0,1
2015,Agosto,México,5266,9646,0,14912
2015,Agosto,República de Moldavia,4,1,0,5
2015,Agosto,Mónaco,2,3,0,5
2015,Agosto,Mongolia,4,3,0,7
2015,Agosto,Montenegro,1,3,0,4
2015,Agosto,Montserrat/Territorio Británico de Ultramar,0,1,0,1
2015,Agosto,Mozambique,1,2,0,3
2015,Agosto,Myanmar,1,3,0,4
2015,Agosto,Nepal,0,4,0,4
2015,Agosto,Nicaragua,93,124,0,217
2015,Agosto,Nigeria,13,13,0,26
2015,Agosto,Noruega,88,155,0,243
2015,Agosto,Nueva Zelanda,90,120,0,210
2015,Agosto,Omán,0,2,0,2
2015,Agosto,Papúa Nueva Guinea,1,2,0,3
2015,Agosto,Pakistán,7,24,0,31
2015,Agosto,Panamá,2333,2975,0,5308
2015,Agosto,Paraguay,275,234,0,509
2015,Agosto,Perú,5665,7177,0,12842
2015,Agosto,Palestina,0,1,0,1
2015,Agosto,Polonia,160,193,0,353
2015,Agosto,Portugal,347,609,0,956
2015,Agosto,Qatar,0,3,0,3
2015,Agosto,Reino Unido de Gran Bretaña e Irlanda del Norte,1354,2474,0,3828
2015,Agosto,República CentroÁfricana,5,0,0,5
2015,Agosto,Federación de Rusia,193,216,0,409
2015,Agosto,República Dominicana,705,944,0,1649
2015,Agosto,Rumania,54,83,0,137
2015,Agosto,San Cristóbal y Nevis,1,5,0,6
2015,Agosto,San Marino,0,1,0,1
2015,Agosto,San  Vicente y las Granadinas,2,8,0,10
2015,Agosto,Santa Lucia,3,9,0,12
2015,Agosto,Santa Sede/Ciudad del Vaticano,0,2,0,2
2015,Agosto,Senegal,1,4,0,5
2015,Agosto,Serbia,12,22,0,34
2015,Agosto,Sierra Leona,0,5,0,5
2015,Agosto,Singapur,17,28,0,45
2015,Agosto,República Árabe Siria,1,2,0,3
2015,Agosto,Sri Lanka,0,2,0,2
2015,Agosto,Sudáfrica,69,139,0,208
2015,Agosto,Suecia,138,229,0,367
2015,Agosto,Suiza,489,703,0,1192
2015,Agosto,Surinam,23,25,0,48
2015,Agosto,Taiwán,63,83,0,146
2015,Agosto,Tailandia,11,7,0,18
2015,Agosto,Tanzania,1,4,0,5
2015,Agosto,Togo,0,1,0,1
2015,Agosto,Trinidad y Tobago,63,94,0,157
2015,Agosto,Túnez,2,5,0,7
2015,Agosto,Turquía,47,107,0,154
2015,Agosto,Ucrania,22,39,0,61
2015,Agosto,Uganda,7,8,0,15
2015,Agosto,Uruguay,387,635,0,1022
2015,Agosto,Uzbekistán,2,0,0,2
2015,Agosto,Venezuela,19595,20718,0,40313
2015,Agosto,Vietnam,9,9,0,18
2015,Agosto,Islas Vírgenes Británicas/Territorio Británico de Ultramar,0,1,0,1
2015,Agosto,Zambia,0,1,0,1
2015,Agosto,Zimbabue,0,6,0,6
2015,Agosto,Islas Turcas y Caicos/Territorio Británico de Ultramar,0,1,0,1
2015,Agosto,Desconocido,65,128,0,193
2015,Septiembre,Afganistán,1,2,0,3
2015,Septiembre,Albania,3,3,0,6
2015,Septiembre,Alemania,1616,2528,0,4144
2015,Septiembre,Andorra,2,10,0,12
2015,Septiembre,Angola,1,3,0,4
2015,Septiembre,Antigua y Barbuda,1,12,0,13
2015,Septiembre,Países Bajos,1164,1918,0,3082
2015,Septiembre,Arabia Saudita,2,23,0,25
2015,Septiembre,Argelia,2,9,0,11
2015,Septiembre,Argentina,4268,5560,0,9828
2015,Septiembre,República de Armenia,1,4,0,5
2015,Septiembre,Aruba,2,2,0,4
2015,Septiembre,Australia,442,642,0,1084
2015,Septiembre,Austria,141,268,0,409
2015,Septiembre,Azerbaiyán,1,8,0,9
2015,Septiembre,Bahamas,5,15,0,20
2015,Septiembre,Bahréin,3,14,0,17
2015,Septiembre,Bangladesh,3,14,0,17
2015,Septiembre,Barbados,3,12,0,15
2015,Septiembre,República de Belarús,2,7,0,9
2015,Septiembre,Bélgica,171,378,0,549
2015,Septiembre,Belice,5,15,0,20
2015,Septiembre,Benín,0,8,0,8
2015,Septiembre,Bermudas/Territorio Británico de Ultramar,0,2,0,2
2015,Septiembre,Bolivia,573,718,0,1291
2015,Septiembre,Bosnia y Herzegovina,0,3,0,3
2015,Septiembre,Botsuana,1,2,0,3
2015,Septiembre,Brasil,5449,6597,0,12046
2015,Septiembre,Bulgaria,32,32,0,64
2015,Septiembre,Burkina Faso,1,1,0,2
2015,Septiembre,Burundi,0,1,0,1
2015,Septiembre,Bután,1,1,0,2
2015,Septiembre,Islas Caimán/Territorio Británico de Ultramar,0,3,0,3
2015,Septiembre,Camboya,3,3,0,6
2015,Septiembre,Camerún,1,10,0,11
2015,Septiembre,Canadá,748,1478,0,2226
2015,Septiembre,Chad,0,3,0,3
2015,Septiembre,España,2966,6997,0,9963
2015,Septiembre,República Del Congo,0,4,0,4
2015,Septiembre,República Democrática del Congo,4,5,0,9
2015,Septiembre,República de Corea,193,496,0,689
2015,Septiembre,Costa de Marfil,2,11,0,13
2015,Septiembre,Costa Rica,994,1479,0,2473
2015,Septiembre,Croacia,19,45,0,64
2015,Septiembre,Cuba,371,587,0,958
2015,Septiembre,República Checa,30,52,0,82
2015,Septiembre,Chile,4083,5190,0,9273
2015,Septiembre,China,340,855,0,1195
2015,Septiembre,Chipre,4,6,0,10
2015,Septiembre,Dinamarca,75,169,0,244
2015,Septiembre,Dominica,0,2,0,2
2015,Septiembre,Ecuador,5651,8095,0,13746
2015,Septiembre,Egipto,4,33,0,37
2015,Septiembre,El Salvador,814,1060,0,1874
2015,Septiembre,Emiratos Árabes,0,8,0,8
2015,Septiembre,Eritrea,2,1,0,3
2015,Septiembre,Eslovaquia,17,23,0,40
2015,Septiembre,Eslovenia,24,23,0,47
2015,Septiembre,Estados Unidos de América,10284,20625,0,30909
2015,Septiembre,Estonia,7,7,0,14
2015,Septiembre,Etiopia,5,7,0,12
2015,Septiembre,Filipinas,40,178,0,218
2015,Septiembre,Finlandia,32,83,0,115
2015,Septiembre,Francia,1158,2243,0,3401
2015,Septiembre,Gambia,0,1,0,1
2015,Septiembre,Georgia,2,10,0,12
2015,Septiembre,Ghana,1,14,0,15
2015,Septiembre,Granada,0,4,0,4
2015,Septiembre,Grecia,23,66,0,89
2015,Septiembre,Guatemala,593,1274,0,1867
2015,Septiembre,Guyana,7,19,0,26
2015,Septiembre,Guinea,0,2,0,2
2015,Septiembre,Guinea Ecuatorial,0,1,0,1
2015,Septiembre,Haití,8,25,0,33
2015,Septiembre,Honduras,344,555,0,899
2015,Septiembre,Hong Kong,4,1,0,5
2015,Septiembre,Hungría,27,56,0,83
2015,Septiembre,India,90,585,0,675
2015,Septiembre,Indonesia,9,27,0,36
2015,Septiembre,Iraq,0,5,0,5
2015,Septiembre,Irán,5,18,0,23
2015,Septiembre,República de Irlanda,90,254,0,344
2015,Septiembre,Islandia,4,8,0,12
2015,Septiembre,Israel,199,646,0,845
2015,Septiembre,Italia,996,2249,0,3245
2015,Septiembre,Jamaica,22,63,0,85
2015,Septiembre,Japón,226,549,0,775
2015,Septiembre,Jordania,7,16,0,23
2015,Septiembre,Kazajistán,4,2,0,6
2015,Septiembre,Kenia,15,24,0,39
2015,Septiembre,Kiribati,0,5,0,5
2015,Septiembre,Kirguistán,0,2,0,2
2015,Septiembre,Kuwait,2,9,0,11
2015,Septiembre,Letonia,4,14,0,18
2015,Septiembre,Lituania,25,17,0,42
2015,Septiembre,Líbano,25,36,0,61
2015,Septiembre,Liechtenstein,2,0,0,2
2015,Septiembre,Luxemburgo,9,8,0,17
2015,Septiembre,Macedonia,0,1,0,1
2015,Septiembre,Madagascar,0,6,0,6
2015,Septiembre,Malasia,17,72,0,89
2015,Septiembre,Maldivas,0,3,0,3
2015,Septiembre,Malta,4,8,0,12
2015,Septiembre,Marruecos,12,20,0,32
2015,Septiembre,Mauricio,1,4,0,5
2015,Septiembre,México,4628,8707,0,13335
2015,Septiembre,República de Moldavia,0,1,0,1
2015,Septiembre,Mónaco,1,1,0,2
2015,Septiembre,Mongolia,7,5,0,12
2015,Septiembre,Montenegro,3,4,0,7
2015,Septiembre,Mozambique,3,8,0,11
2015,Septiembre,Myanmar,0,1,0,1
2015,Septiembre,Namibia,1,2,0,3
2015,Septiembre,Nepal,3,7,0,10
2015,Septiembre,Nicaragua,120,155,0,275
2015,Septiembre,Nigeria,2,18,0,20
2015,Septiembre,Níger,0,2,0,2
2015,Septiembre,Noruega,60,156,0,216
2015,Septiembre,Nueva Zelanda,65,121,0,186
2015,Septiembre,Omán,0,5,0,5
2015,Septiembre,Pakistán,4,14,0,18
2015,Septiembre,Panamá,2620,2862,0,5482
2015,Septiembre,Paraguay,314,363,0,677
2015,Septiembre,Perú,5044,6220,0,11264
2015,Septiembre,Palestina,6,6,0,12
2015,Septiembre,Polonia,133,228,0,361
2015,Septiembre,Portugal,283,628,0,911
2015,Septiembre,Qatar,1,8,0,9
2015,Septiembre,Reino Unido de Gran Bretaña e Irlanda del Norte,1034,2123,0,3157
2015,Septiembre,Federación de Rusia,190,292,0,482
2015,Septiembre,República Dominicana,575,887,0,1462
2015,Septiembre,Rumania,56,90,0,146
2015,Septiembre,San Cristóbal y Nevis,1,2,0,3
2015,Septiembre,Samoa Occidental,1,0,0,1
2015,Septiembre,San Marino,0,2,0,2
2015,Septiembre,San  Vicente y las Granadinas,0,4,0,4
2015,Septiembre,Santa Lucia,4,8,0,12
2015,Septiembre,Santa Sede/Ciudad del Vaticano,0,1,0,1
2015,Septiembre,Senegal,1,5,0,6
2015,Septiembre,Serbia,3,9,0,12
2015,Septiembre,Seychelles,2,1,0,3
2015,Septiembre,Sierra Leona,0,1,0,1
2015,Septiembre,Singapur,21,22,0,43
2015,Septiembre,República Árabe Siria,0,5,0,5
2015,Septiembre,Sri Lanka,2,5,0,7
2015,Septiembre,Sudáfrica,49,118,0,167
2015,Septiembre,Sudán,0,4,0,4
2015,Septiembre,Suecia,143,275,0,418
2015,Septiembre,Suiza,332,630,0,962
2015,Septiembre,Surinam,25,28,0,53
2015,Septiembre,Suazilandia,0,2,0,2
2015,Septiembre,Taiwán,73,112,0,185
2015,Septiembre,Tailandia,12,17,0,29
2015,Septiembre,Tanzania,2,1,0,3
2015,Septiembre,República Democrática de Timor Oriental,0,1,0,1
2015,Septiembre,Togo,0,2,0,2
2015,Septiembre,Trinidad y Tobago,31,73,0,104
2015,Septiembre,Túnez,7,11,0,18
2015,Septiembre,Turquía,40,145,0,185
2015,Septiembre,Ucrania,24,33,0,57
2015,Septiembre,Uganda,2,8,0,10
2015,Septiembre,Uruguay,392,614,0,1006
2015,Septiembre,Uzbekistán,1,1,0,2
2015,Septiembre,Venezuela,13037,14382,0,27419
2015,Septiembre,Vietnam,2,5,0,7
2015,Septiembre,República Árabe de Yemen,0,1,0,1
2015,Septiembre,Zambia,6,8,0,14
2015,Septiembre,Zimbabue,2,19,0,21
2015,Septiembre,Anguila/Territorio Británico de Ultramar,0,1,0,1
2015,Septiembre,Desconocido,78,170,0,248
2015,Octubre,Albania,0,4,0,4
2015,Octubre,Alemania,1787,2942,0,4729
2015,Octubre,Andorra,1,8,0,9
2015,Octubre,Angola,0,2,0,2
2015,Octubre,Antigua y Barbuda,6,13,0,19
2015,Octubre,Países Bajos,1454,2255,0,3709
2015,Octubre,Arabia Saudita,0,6,0,6
2015,Octubre,Argelia,1,10,0,11
2015,Octubre,Argentina,4074,5774,0,9848
2015,Octubre,República de Armenia,1,0,0,1
2015,Octubre,Australia,420,765,0,1185
2015,Octubre,Austria,124,247,0,371
2015,Octubre,Azerbaiyán,3,10,0,13
2015,Octubre,Bahamas,8,11,0,19
2015,Octubre,Bahréin,0,2,0,2
2015,Octubre,Bangladesh,1,3,0,4
2015,Octubre,Barbados,15,28,0,43
2015,Octubre,República de Belarús,14,13,0,27
2015,Octubre,Bélgica,188,463,0,651
2015,Octubre,Belice,6,16,0,22
2015,Octubre,Benín,0,3,0,3
2015,Octubre,Bermudas/Territorio Británico de Ultramar,6,8,0,14
2015,Octubre,Bolivia,673,838,0,1511
2015,Octubre,Bosnia y Herzegovina,2,2,0,4
2015,Octubre,Brasil,6129,6863,0,12992
2015,Octubre,Bulgaria,23,35,0,58
2015,Octubre,Burundi,2,0,0,2
2015,Octubre,Cabo Verde,0,1,0,1
2015,Octubre,Islas Caimán/Territorio Británico de Ultramar,4,0,0,4
2015,Octubre,Camerún,0,4,0,4
2015,Octubre,Canadá,990,1754,0,2744
2015,Octubre,Chad,1,2,0,3
2015,Octubre,España,2899,6635,0,9534
2015,Octubre,República Democrática del Congo,1,3,0,4
2015,Octubre,República de Corea,211,537,0,748
2015,Octubre,Costa de Marfil,0,2,0,2
2015,Octubre,Costa Rica,1085,1501,0,2586
2015,Octubre,Croacia,11,63,0,74
2015,Octubre,Cuba,337,559,0,896
2015,Octubre,República Checa,39,102,0,141
2015,Octubre,Chile,4442,5180,0,9622
2015,Octubre,China,351,799,0,1150
2015,Octubre,Chipre,1,4,0,5
2015,Octubre,Dinamarca,110,242,0,352
2015,Octubre,Dominica,3,3,0,6
2015,Octubre,Ecuador,6796,8800,0,15596
2015,Octubre,Egipto,11,15,0,26
2015,Octubre,El Salvador,957,1174,0,2131
2015,Octubre,Emiratos Árabes,0,6,0,6
2015,Octubre,Eslovaquia,27,36,0,63
2015,Octubre,Eslovenia,12,29,0,41
2015,Octubre,Estados Unidos de América,10516,20838,0,31354
2015,Octubre,Estonia,7,19,0,26
2015,Octubre,Etiopia,0,1,0,1
2015,Octubre,Filipinas,31,277,0,308
2015,Octubre,Finlandia,53,99,0,152
2015,Octubre,Francia,1456,2771,0,4227
2015,Octubre,Gambia,1,0,0,1
2015,Octubre,Georgia,2,5,0,7
2015,Octubre,Ghana,0,2,0,2
2015,Octubre,Granada,2,6,0,8
2015,Octubre,Grecia,25,81,0,106
2015,Octubre,Guatemala,668,1217,0,1885
2015,Octubre,Guyana,13,19,0,32
2015,Octubre,Guinea,1,2,0,3
2015,Octubre,Guinea Ecuatorial,1,0,0,1
2015,Octubre,Haití,11,30,0,41
2015,Octubre,Honduras,443,502,0,945
2015,Octubre,Hong Kong,12,4,0,16
2015,Octubre,Hungría,47,68,0,115
2015,Octubre,India,54,466,0,520
2015,Octubre,Indonesia,9,40,0,49
2015,Octubre,Iraq,0,1,0,1
2015,Octubre,Irán,0,20,0,20
2015,Octubre,República de Irlanda,136,213,0,349
2015,Octubre,Islandia,13,13,0,26
2015,Octubre,Israel,137,583,0,720
2015,Octubre,Italia,749,2312,0,3061
2015,Octubre,Jamaica,56,61,0,117
2015,Octubre,Japón,134,560,0,694
2015,Octubre,Jordania,1,2,0,3
2015,Octubre,Kazajistán,6,6,0,12
2015,Octubre,Kenia,6,6,0,12
2015,Octubre,Kiribati,0,1,0,1
2015,Octubre,Kirguistán,1,6,0,7
2015,Octubre,Kuwait,0,2,0,2
2015,Octubre,República de Kosovo,0,1,0,1
2015,Octubre,Letonia,17,21,0,38
2015,Octubre,Lituania,35,30,0,65
2015,Octubre,Líbano,15,42,0,57
2015,Octubre,Liechtenstein,1,2,0,3
2015,Octubre,Luxemburgo,11,21,0,32
2015,Octubre,Macedonia,0,3,0,3
2015,Octubre,Madagascar,2,2,0,4
2015,Octubre,Malasia,21,40,0,61
2015,Octubre,Malí,2,2,0,4
2015,Octubre,Malta,3,8,0,11
2015,Octubre,Marruecos,8,12,0,20
2015,Octubre,Mauricio,2,4,0,6
2015,Octubre,México,4535,8025,0,12560
2015,Octubre,Mónaco,0,1,0,1
2015,Octubre,Mongolia,1,0,0,1
2015,Octubre,Micronesia,0,1,0,1
2015,Octubre,Mozambique,1,1,0,2
2015,Octubre,Myanmar,1,2,0,3
2015,Octubre,Namibia,0,1,0,1
2015,Octubre,Nepal,1,13,0,14
2015,Octubre,Nicaragua,107,120,0,227
2015,Octubre,Nigeria,1,7,0,8
2015,Octubre,Noruega,117,173,0,290
2015,Octubre,Nueva Zelanda,89,145,0,234
2015,Octubre,Pakistán,8,16,0,24
2015,Octubre,Panamá,3122,3462,0,6584
2015,Octubre,Paraguay,385,286,0,671
2015,Octubre,Perú,6556,7823,0,14379
2015,Octubre,Palestina,0,3,0,3
2015,Octubre,Polonia,136,264,0,400
2015,Octubre,Portugal,343,675,0,1018
2015,Octubre,Qatar,0,4,0,4
2015,Octubre,Reino Unido de Gran Bretaña e Irlanda del Norte,1000,2301,0,3301
2015,Octubre,Federación de Rusia,233,314,0,547
2015,Octubre,República Dominicana,538,713,0,1251
2015,Octubre,Rumania,51,112,0,163
2015,Octubre,Rwanda,1,0,0,1
2015,Octubre,San Cristóbal y Nevis,2,4,0,6
2015,Octubre,Samoa Occidental,1,0,0,1
2015,Octubre,San  Vicente y las Granadinas,3,6,0,9
2015,Octubre,Santa Lucia,4,11,0,15
2015,Octubre,Senegal,0,3,0,3
2015,Octubre,Serbia,1,6,0,7
2015,Octubre,Singapur,21,22,0,43
2015,Octubre,República Árabe Siria,1,2,0,3
2015,Octubre,Sri Lanka,0,3,0,3
2015,Octubre,Sudáfrica,43,98,0,141
2015,Octubre,Suecia,216,361,0,577
2015,Octubre,Suiza,476,839,0,1315
2015,Octubre,Surinam,20,48,0,68
2015,Octubre,Taiwán,123,144,0,267
2015,Octubre,República de Tayikistán,0,1,0,1
2015,Octubre,Tailandia,45,43,0,88
2015,Octubre,Tanzania,1,1,0,2
2015,Octubre,Togo,1,1,0,2
2015,Octubre,Trinidad y Tobago,43,82,0,125
2015,Octubre,Túnez,1,4,0,5
2015,Octubre,Turquía,33,148,0,181
2015,Octubre,Ucrania,38,52,0,90
2015,Octubre,Uganda,2,1,0,3
2015,Octubre,Uruguay,378,570,0,948
2015,Octubre,Uzbekistán,1,4,0,5
2015,Octubre,Venezuela,12192,13225,0,25417
2015,Octubre,Vietnam,10,1,0,11
2015,Octubre,República Árabe de Yemen,0,2,0,2
2015,Octubre,Zambia,2,2,0,4
2015,Octubre,Zimbabue,0,6,0,6
2015,Octubre,Anguila/Territorio Británico de Ultramar,0,1,0,1
2015,Octubre,Desconocido,54,121,0,175
2015,Noviembre,Albania,2,5,0,7
2015,Noviembre,Alemania,1803,3218,0,5021
2015,Noviembre,Andorra,1,10,0,11
2015,Noviembre,Antigua y Barbuda,8,18,0,26
2015,Noviembre,Países Bajos,1308,2116,0,3424
2015,Noviembre,Arabia Saudita,1,9,0,10
2015,Noviembre,Argelia,3,2,0,5
2015,Noviembre,Argentina,4431,6296,0,10727
2015,Noviembre,República de Armenia,0,2,0,2
2015,Noviembre,Aruba,2,1,0,3
2015,Noviembre,Australia,526,859,0,1385
2015,Noviembre,Austria,159,334,0,493
2015,Noviembre,Azerbaiyán,0,2,0,2
2015,Noviembre,Bahamas,7,8,0,15
2015,Noviembre,Bahréin,2,1,0,3
2015,Noviembre,Bangladesh,0,4,0,4
2015,Noviembre,Barbados,12,14,0,26
2015,Noviembre,República de Belarús,5,6,0,11
2015,Noviembre,Bélgica,238,549,0,787
2015,Noviembre,Belice,16,20,0,36
2015,Noviembre,Benín,1,3,0,4
2015,Noviembre,Bermudas/Territorio Británico de Ultramar,2,7,0,9
2015,Noviembre,Bolivia,708,853,0,1561
2015,Noviembre,Bosnia y Herzegovina,2,3,0,5
2015,Noviembre,Brasil,5228,6904,0,12132
2015,Noviembre,Bulgaria,31,41,0,72
2015,Noviembre,Burundi,0,1,0,1
2015,Noviembre,Cabo Verde,0,3,0,3
2015,Noviembre,Islas Caimán/Territorio Británico de Ultramar,2,4,0,6
2015,Noviembre,Camerún,1,9,0,10
2015,Noviembre,Canadá,1203,2085,0,3288
2015,Noviembre,España,3406,7807,0,11213
2015,Noviembre,República Democrática del Congo,1,5,0,6
2015,Noviembre,República de Corea,277,620,0,897
2015,Noviembre,Costa de Marfil,0,5,0,5
2015,Noviembre,Costa Rica,1156,1716,0,2872
2015,Noviembre,Croacia,11,70,0,81
2015,Noviembre,Cuba,397,627,0,1024
2015,Noviembre,República Checa,70,144,0,214
2015,Noviembre,Chile,3633,5310,0,8943
2015,Noviembre,China,328,932,0,1260
2015,Noviembre,Chipre,4,3,0,7
2015,Noviembre,Dinamarca,127,246,0,373
2015,Noviembre,Dominica,3,9,0,12
2015,Noviembre,Ecuador,5228,7535,0,12763
2015,Noviembre,Egipto,3,24,0,27
2015,Noviembre,El Salvador,1114,1437,0,2551
2015,Noviembre,Emiratos Árabes,0,16,0,16
2015,Noviembre,Eritrea,0,1,0,1
2015,Noviembre,Eslovaquia,17,34,0,51
2015,Noviembre,Eslovenia,16,36,0,52
2015,Noviembre,Estados Unidos de América,12530,24026,0,36556
2015,Noviembre,Estonia,8,17,0,25
2015,Noviembre,Etiopia,2,5,0,7
2015,Noviembre,Islas Fiji,0,1,0,1
2015,Noviembre,Filipinas,41,310,0,351
2015,Noviembre,Finlandia,87,121,0,208
2015,Noviembre,Francia,1597,2913,0,4510
2015,Noviembre,Georgia,5,5,0,10
2015,Noviembre,Ghana,2,6,0,8
2015,Noviembre,Granada,2,7,0,9
2015,Noviembre,Grecia,18,92,0,110
2015,Noviembre,Guatemala,806,1377,0,2183
2015,Noviembre,Guyana,9,16,0,25
2015,Noviembre,Guinea,0,1,0,1
2015,Noviembre,Guinea Ecuatorial,3,0,0,3
2015,Noviembre,Guinea Bissau,0,1,0,1
2015,Noviembre,Haití,14,32,0,46
2015,Noviembre,Honduras,373,558,0,931
2015,Noviembre,Hong Kong,4,3,0,7
2015,Noviembre,Hungría,48,49,0,97
2015,Noviembre,India,103,559,0,662
2015,Noviembre,Indonesia,16,63,0,79
2015,Noviembre,Irán,2,14,0,16
2015,Noviembre,República de Irlanda,147,275,0,422
2015,Noviembre,Islandia,5,8,0,13
2015,Noviembre,Israel,133,600,0,733
2015,Noviembre,Italia,756,2755,0,3511
2015,Noviembre,Jamaica,24,44,0,68
2015,Noviembre,Japón,153,607,0,760
2015,Noviembre,Jordania,3,9,0,12
2015,Noviembre,Kazajistán,3,15,0,18
2015,Noviembre,Kenia,4,7,0,11
2015,Noviembre,Kirguistán,2,6,0,8
2015,Noviembre,Kuwait,1,1,0,2
2015,Noviembre,República de Kosovo,0,1,0,1
2015,Noviembre,Letonia,10,11,0,21
2015,Noviembre,Lituania,36,23,0,59
2015,Noviembre,Líbano,13,24,0,37
2015,Noviembre,Liechtenstein,1,4,0,5
2015,Noviembre,Luxemburgo,10,14,0,24
2015,Noviembre,Macedonia,0,4,0,4
2015,Noviembre,Madagascar,1,1,0,2
2015,Noviembre,Malasia,29,32,0,61
2015,Noviembre,Malta,2,15,0,17
2015,Noviembre,Marruecos,5,25,0,30
2015,Noviembre,Mauricio,1,3,0,4
2015,Noviembre,Mauritania,0,1,0,1
2015,Noviembre,México,4350,8727,0,13077
2015,Noviembre,República de Moldavia,4,1,0,5
2015,Noviembre,Mongolia,1,1,0,2
2015,Noviembre,Montenegro,0,3,0,3
2015,Noviembre,Mozambique,0,1,0,1
2015,Noviembre,Myanmar,1,1,0,2
2015,Noviembre,Nepal,1,4,0,5
2015,Noviembre,Nicaragua,93,123,0,216
2015,Noviembre,Nigeria,3,10,0,13
2015,Noviembre,Noruega,150,241,0,391
2015,Noviembre,Nueva Zelanda,79,138,0,217
2015,Noviembre,Omán,0,3,0,3
2015,Noviembre,Pakistán,4,19,0,23
2015,Noviembre,Panamá,3574,3821,0,7395
2015,Noviembre,Paraguay,372,445,0,817
2015,Noviembre,Perú,4754,6416,0,11170
2015,Noviembre,Palestina,0,2,0,2
2015,Noviembre,Polonia,228,294,0,522
2015,Noviembre,Portugal,372,680,0,1052
2015,Noviembre,Qatar,0,1,0,1
2015,Noviembre,Reino Unido de Gran Bretaña e Irlanda del Norte,1024,2543,0,3567
2015,Noviembre,Federación de Rusia,186,381,0,567
2015,Noviembre,República Dominicana,688,1031,0,1719
2015,Noviembre,Rumania,68,133,0,201
2015,Noviembre,San Cristóbal y Nevis,0,7,0,7
2015,Noviembre,Samoa Occidental,1,0,0,1
2015,Noviembre,San  Vicente y las Granadinas,1,4,0,5
2015,Noviembre,Santa Lucia,8,6,0,14
2015,Noviembre,Senegal,0,2,0,2
2015,Noviembre,Serbia,8,14,0,22
2015,Noviembre,Sierra Leona,0,2,0,2
2015,Noviembre,Singapur,16,28,0,44
2015,Noviembre,República Árabe Siria,0,2,0,2
2015,Noviembre,Sri Lanka,3,6,0,9
2015,Noviembre,Sudáfrica,44,99,0,143
2015,Noviembre,Sudán,0,1,0,1
2015,Noviembre,Suecia,244,442,0,686
2015,Noviembre,Suiza,435,804,0,1239
2015,Noviembre,Surinam,38,46,0,84
2015,Noviembre,Taiwán,66,111,0,177
2015,Noviembre,República de Tayikistán,1,2,0,3
2015,Noviembre,Tailandia,39,20,0,59
2015,Noviembre,Tanzania,0,3,0,3
2015,Noviembre,Trinidad y Tobago,53,104,0,157
2015,Noviembre,Túnez,2,9,0,11
2015,Noviembre,Turkmenistán,1,0,0,1
2015,Noviembre,Turquía,42,131,0,173
2015,Noviembre,Ucrania,21,52,0,73
2015,Noviembre,Uganda,3,2,0,5
2015,Noviembre,Uruguay,349,671,0,1020
2015,Noviembre,Uzbekistán,1,0,0,1
2015,Noviembre,Venezuela,12214,13777,0,25991
2015,Noviembre,Vietnam,3,3,0,6
2015,Noviembre,Zambia,0,1,0,1
2015,Noviembre,Zimbabue,0,3,0,3
2015,Noviembre,Anguila/Territorio Británico de Ultramar,2,1,0,3
2015,Noviembre,Desconocido,96,189,0,285
2015,Diciembre,Albania,0,3,0,3
2015,Diciembre,Alemania,2298,3480,0,5778
2015,Diciembre,Andorra,2,7,0,9
2015,Diciembre,Angola,0,3,0,3
2015,Diciembre,Antigua y Barbuda,0,7,0,7
2015,Diciembre,Países Bajos,1685,2638,0,4323
2015,Diciembre,Arabia Saudita,2,35,0,37
2015,Diciembre,Argelia,3,5,0,8
2015,Diciembre,Argentina,4579,6314,0,10893
2015,Diciembre,República de Armenia,2,1,0,3
2015,Diciembre,Aruba,0,4,0,4
2015,Diciembre,Australia,769,1223,0,1992
2015,Diciembre,Austria,238,359,0,597
2015,Diciembre,Azerbaiyán,1,3,0,4
2015,Diciembre,Bahamas,1,6,0,7
2015,Diciembre,Bahréin,1,4,0,5
2015,Diciembre,Bangladesh,0,3,0,3
2015,Diciembre,Barbados,6,15,0,21
2015,Diciembre,República de Belarús,4,4,0,8
2015,Diciembre,Bélgica,269,540,0,809
2015,Diciembre,Belice,2,9,0,11
2015,Diciembre,Benín,0,2,0,2
2015,Diciembre,Bermudas/Territorio Británico de Ultramar,1,3,0,4
2015,Diciembre,Bolivia,926,805,0,1731
2015,Diciembre,Bosnia y Herzegovina,1,5,0,6
2015,Diciembre,Botsuana,1,0,0,1
2015,Diciembre,Brasil,6870,6777,0,13647
2015,Diciembre,Bulgaria,27,26,0,53
2015,Diciembre,Islas Caimán/Territorio Británico de Ultramar,2,6,0,8
2015,Diciembre,Camerún,1,0,0,1
2015,Diciembre,Canadá,2463,3439,0,5902
2015,Diciembre,España,3757,6919,0,10676
2015,Diciembre,Comoras,0,1,0,1
2015,Diciembre,República Democrática del Congo,1,0,0,1
2015,Diciembre,República de Corea,353,516,0,869
2015,Diciembre,Costa Rica,1846,2077,0,3923
2015,Diciembre,Croacia,14,59,0,73
2015,Diciembre,Cuba,373,555,0,928
2015,Diciembre,República Checa,75,86,0,161
2015,Diciembre,Chile,3312,4521,0,7833
2015,Diciembre,China,323,707,0,1030
2015,Diciembre,Chipre,2,5,0,7
2015,Diciembre,Dinamarca,172,275,0,447
2015,Diciembre,Dominica,0,2,0,2
2015,Diciembre,Ecuador,6861,9119,0,15980
2015,Diciembre,Egipto,5,19,0,24
2015,Diciembre,El Salvador,1037,1146,0,2183
2015,Diciembre,Emiratos Árabes,2,11,0,13
2015,Diciembre,Eslovaquia,22,35,0,57
2015,Diciembre,Eslovenia,23,36,0,59
2015,Diciembre,Estados Unidos de América,22880,35461,0,58341
2015,Diciembre,Estonia,8,18,0,26
2015,Diciembre,Islas Fiji,1,0,0,1
2015,Diciembre,Filipinas,52,273,0,325
2015,Diciembre,Finlandia,114,164,0,278
2015,Diciembre,Francia,2174,3491,0,5665
2015,Diciembre,Georgia,1,7,0,8
2015,Diciembre,Ghana,0,6,0,6
2015,Diciembre,Granada,1,4,0,5
2015,Diciembre,Grecia,53,111,0,164
2015,Diciembre,Guatemala,921,1174,0,2095
2015,Diciembre,Guyana,6,21,0,27
2015,Diciembre,Guinea,0,1,0,1
2015,Diciembre,Guinea Ecuatorial,2,0,0,2
2015,Diciembre,Guam/Territorio no incorporado de Estados Unidos,1,0,0,1
2015,Diciembre,Haití,10,19,0,29
2015,Diciembre,Honduras,456,436,0,892
2015,Diciembre,Hong Kong,1,0,0,1
2015,Diciembre,Hungría,36,48,0,84
2015,Diciembre,India,104,519,0,623
2015,Diciembre,Indonesia,25,46,0,71
2015,Diciembre,Iraq,0,1,0,1
2015,Diciembre,Irán,6,19,0,25
2015,Diciembre,República de Irlanda,112,249,0,361
2015,Diciembre,Islandia,10,21,0,31
2015,Diciembre,Israel,150,549,0,699
2015,Diciembre,Italia,1141,2682,0,3823
2015,Diciembre,Jamaica,17,34,0,51
2015,Diciembre,Japón,220,502,0,722
2015,Diciembre,Jordania,6,14,0,20
2015,Diciembre,Kazajistán,4,3,0,7
2015,Diciembre,Kenia,5,5,0,10
2015,Diciembre,Kiribati,0,1,0,1
2015,Diciembre,Kuwait,2,12,0,14
2015,Diciembre,República de Kosovo,0,1,0,1
2015,Diciembre,Letonia,10,19,0,29
2015,Diciembre,Lituania,38,35,0,73
2015,Diciembre,Líbano,13,29,0,42
2015,Diciembre,Liechtenstein,5,8,0,13
2015,Diciembre,Luxemburgo,16,19,0,35
2015,Diciembre,Macedonia,1,3,0,4
2015,Diciembre,Malasia,24,21,0,45
2015,Diciembre,Malta,9,19,0,28
2015,Diciembre,Marruecos,8,21,0,29
2015,Diciembre,Mauricio,1,2,0,3
2015,Diciembre,México,5284,7929,0,13213
2015,Diciembre,República de Moldavia,2,0,0,2
2015,Diciembre,Mongolia,1,1,0,2
2015,Diciembre,Montenegro,2,5,0,7
2015,Diciembre,Mozambique,2,2,0,4
2015,Diciembre,Myanmar,3,19,0,22
2015,Diciembre,Namibia,0,1,0,1
2015,Diciembre,Nepal,3,2,0,5
2015,Diciembre,Nicaragua,120,94,0,214
2015,Diciembre,Nigeria,2,4,0,6
2015,Diciembre,Noruega,214,277,0,491
2015,Diciembre,Nueva Zelanda,116,179,0,295
2015,Diciembre,Omán,0,6,0,6
2015,Diciembre,Pakistán,2,12,0,14
2015,Diciembre,Panamá,2751,3543,0,6294
2015,Diciembre,Paraguay,248,194,0,442
2015,Diciembre,Perú,4528,5707,0,10235
2015,Diciembre,Palestina,0,1,0,1
2015,Diciembre,Polonia,146,195,0,341
2015,Diciembre,Portugal,295,551,0,846
2015,Diciembre,Puerto Rico/Territorio de Estados Unidos,0,1,0,1
2015,Diciembre,Qatar,0,1,0,1
2015,Diciembre,Reino Unido de Gran Bretaña e Irlanda del Norte,1639,3149,0,4788
2015,Diciembre,Federación de Rusia,206,249,0,455
2015,Diciembre,República Dominicana,577,809,0,1386
2015,Diciembre,Rumania,69,86,0,155
2015,Diciembre,Rwanda,0,1,0,1
2015,Diciembre,San Cristóbal y Nevis,2,5,0,7
2015,Diciembre,San Marino,1,7,0,8
2015,Diciembre,San  Vicente y las Granadinas,2,3,0,5
2015,Diciembre,Santa Lucia,4,3,0,7
2015,Diciembre,Santa Sede/Ciudad del Vaticano,0,1,0,1
2015,Diciembre,Senegal,1,0,0,1
2015,Diciembre,Serbia,20,13,0,33
2015,Diciembre,Singapur,38,53,0,91
2015,Diciembre,República Árabe Siria,0,2,0,2
2015,Diciembre,Somalia,0,1,0,1
2015,Diciembre,Sri Lanka,3,1,0,4
2015,Diciembre,Sudáfrica,46,83,0,129
2015,Diciembre,Sudán,0,2,0,2
2015,Diciembre,Suecia,543,771,0,1314
2015,Diciembre,Suiza,711,1264,0,1975
2015,Diciembre,Surinam,6,12,0,18
2015,Diciembre,Taiwán,64,59,0,123
2015,Diciembre,Tailandia,41,17,0,58
2015,Diciembre,Togo,0,2,0,2
2015,Diciembre,Trinidad y Tobago,36,98,0,134
2015,Diciembre,Túnez,2,8,0,10
2015,Diciembre,Turquía,53,144,0,197
2015,Diciembre,Ucrania,38,35,0,73
2015,Diciembre,Uganda,1,2,0,3
2015,Diciembre,Uruguay,247,443,0,690
2015,Diciembre,Uzbekistán,3,2,0,5
2015,Diciembre,Venezuela,13310,13736,0,27046
2015,Diciembre,Vietnam,6,2,0,8
2015,Diciembre,República Árabe de Yemen,0,1,0,1
2015,Diciembre,Zambia,0,1,0,1
2015,Diciembre,Zimbabue,0,2,0,2
2015,Diciembre,Desconocido,33,90,0,123
2016,Enero,Albania,3,5,0,8
2016,Enero,Alemania,2196,3282,0,5478
2016,Enero,Andorra,3,10,0,13
2016,Enero,Antigua y Barbuda,1,10,0,11
2016,Enero,Países Bajos,1418,2238,0,3656
2016,Enero,Arabia Saudita,2,9,0,11
2016,Enero,Argelia,3,3,0,6
2016,Enero,Argentina,8324,8375,0,16699
2016,Enero,República de Armenia,2,0,0,2
2016,Enero,Aruba,2,0,0,2
2016,Enero,Australia,639,1006,0,1645
2016,Enero,Austria,199,358,0,557
2016,Enero,Azerbaiyán,2,2,0,4
2016,Enero,Bahamas,9,12,0,21
2016,Enero,Bahréin,0,1,0,1
2016,Enero,Bangladesh,0,3,0,3
2016,Enero,Barbados,13,14,0,27
2016,Enero,República de Belarús,3,11,0,14
2016,Enero,Bélgica,259,529,0,788
2016,Enero,Belice,4,11,0,15
2016,Enero,Benín,1,0,0,1
2016,Enero,Bermudas/Territorio Británico de Ultramar,0,4,0,4
2016,Enero,Bolivia,862,956,0,1818
2016,Enero,Bosnia y Herzegovina,1,2,0,3
2016,Enero,Brasil,8946,8877,0,17823
2016,Enero,Bulgaria,38,52,0,90
2016,Enero,Burkina Faso,0,2,0,2
2016,Enero,Cabo Verde,1,1,0,2
2016,Enero,Islas Caimán/Territorio Británico de Ultramar,2,4,0,6
2016,Enero,Camerún,2,2,0,4
2016,Enero,Canadá,2344,3283,0,5627
2016,Enero,España,3188,6732,0,9920
2016,Enero,República Del Congo,0,2,0,2
2016,Enero,República Democrática del Congo,1,4,0,5
2016,Enero,República de Corea,494,688,0,1182
2016,Enero,Costa de Marfil,0,3,0,3
2016,Enero,Costa Rica,1455,1644,0,3099
2016,Enero,Croacia,19,71,0,90
2016,Enero,Cuba,231,377,0,608
2016,Enero,República Checa,69,94,0,163
2016,Enero,Chile,4429,5278,0,9707
2016,Enero,China,397,826,0,1223
2016,Enero,Chipre,2,6,0,8
2016,Enero,Dinamarca,190,304,0,494
2016,Enero,Dominica,1,6,0,7
2016,Enero,Ecuador,4475,6682,0,11157
2016,Enero,Egipto,11,33,0,44
2016,Enero,El Salvador,848,1093,0,1941
2016,Enero,Emiratos Árabes,1,3,0,4
2016,Enero,Eslovaquia,31,59,0,90
2016,Enero,Eslovenia,41,49,0,90
2016,Enero,Estados Unidos de América,13390,23665,0,37055
2016,Enero,Estonia,11,19,0,30
2016,Enero,Etiopia,0,2,0,2
2016,Enero,Filipinas,43,228,0,271
2016,Enero,Finlandia,80,115,0,195
2016,Enero,Francia,2485,3628,0,6113
2016,Enero,Georgia,2,10,0,12
2016,Enero,Ghana,1,6,0,7
2016,Enero,Granada,2,7,0,9
2016,Enero,Grecia,41,112,0,153
2016,Enero,Guatemala,521,889,0,1410
2016,Enero,Guyana,12,20,0,32
2016,Enero,Guinea Ecuatorial,0,4,0,4
2016,Enero,Haití,15,30,0,45
2016,Enero,Honduras,320,381,0,701
2016,Enero,Hungría,51,66,0,117
2016,Enero,India,93,545,0,638
2016,Enero,Indonesia,11,28,0,39
2016,Enero,Iraq,0,2,0,2
2016,Enero,Irán,6,13,0,19
2016,Enero,República de Irlanda,125,256,0,381
2016,Enero,Islandia,16,21,0,37
2016,Enero,Israel,192,705,0,897
2016,Enero,Italia,1314,2957,0,4271
2016,Enero,Jamaica,39,44,0,83
2016,Enero,Islas Salomón,1,0,0,1
2016,Enero,Japón,227,559,0,786
2016,Enero,Jordania,3,8,0,11
2016,Enero,Kazajistán,7,7,0,14
2016,Enero,Kenia,7,9,0,16
2016,Enero,Kuwait,3,5,0,8
2016,Enero,República de Kosovo,0,3,0,3
2016,Enero,República Democrática Popular  Lao,0,1,0,1
2016,Enero,Letonia,15,31,0,46
2016,Enero,Lituania,39,32,0,71
2016,Enero,Líbano,18,24,0,42
2016,Enero,Libia,0,1,0,1
2016,Enero,Liechtenstein,2,5,0,7
2016,Enero,Luxemburgo,10,13,0,23
2016,Enero,Macedonia,2,3,0,5
2016,Enero,Madagascar,1,1,0,2
2016,Enero,Malasia,24,35,0,59
2016,Enero,Malawi,1,0,0,1
2016,Enero,Malí,1,2,0,3
2016,Enero,Malta,12,14,0,26
2016,Enero,Marruecos,12,23,0,35
2016,Enero,Mauricio,0,2,0,2
2016,Enero,México,4500,7473,0,11973
2016,Enero,República de Moldavia,3,0,0,3
2016,Enero,Mónaco,1,1,0,2
2016,Enero,Mongolia,0,1,0,1
2016,Enero,Montenegro,0,2,0,2
2016,Enero,Mozambique,1,1,0,2
2016,Enero,Myanmar,0,4,0,4
2016,Enero,Nepal,2,4,0,6
2016,Enero,Nicaragua,111,109,0,220
2016,Enero,Nigeria,5,18,0,23
2016,Enero,Noruega,172,240,0,412
2016,Enero,Nueva Zelanda,82,151,0,233
2016,Enero,Omán,0,1,0,1
2016,Enero,Pakistán,8,15,0,23
2016,Enero,Panamá,2869,3060,0,5929
2016,Enero,Paraguay,357,321,0,678
2016,Enero,Perú,4980,6146,0,11126
2016,Enero,Palestina,1,1,0,2
2016,Enero,Polonia,192,322,0,514
2016,Enero,Portugal,419,774,0,1193
2016,Enero,Qatar,0,3,0,3
2016,Enero,Reino Unido de Gran Bretaña e Irlanda del Norte,2142,3368,0,5510
2016,Enero,República CentroÁfricana,5,0,0,5
2016,Enero,Federación de Rusia,318,429,0,747
2016,Enero,República Dominicana,495,716,0,1211
2016,Enero,Rumania,70,113,0,183
2016,Enero,San Cristóbal y Nevis,2,4,0,6
2016,Enero,San  Vicente y las Granadinas,0,4,0,4
2016,Enero,Santa Lucia,6,3,0,9
2016,Enero,Santa Sede/Ciudad del Vaticano,0,2,0,2
2016,Enero,Senegal,1,1,0,2
2016,Enero,Serbia,21,37,0,58
2016,Enero,Sierra Leona,0,2,0,2
2016,Enero,Singapur,22,39,0,61
2016,Enero,República Árabe Siria,0,3,0,3
2016,Enero,Sri Lanka,2,3,0,5
2016,Enero,Sudáfrica,59,95,0,154
2016,Enero,Suecia,341,522,0,863
2016,Enero,Suiza,680,1024,0,1704
2016,Enero,Surinam,14,25,0,39
2016,Enero,Taiwán,65,96,0,161
2016,Enero,Tailandia,9,6,0,15
2016,Enero,Tanzania,0,2,0,2
2016,Enero,Trinidad y Tobago,27,77,0,104
2016,Enero,Túnez,1,11,0,12
2016,Enero,Turquía,50,180,0,230
2016,Enero,Ucrania,37,59,0,96
2016,Enero,Uganda,1,2,0,3
2016,Enero,Uruguay,393,535,0,928
2016,Enero,Venezuela,10712,12115,0,22827
2016,Enero,Vietnam,1,8,0,9
2016,Enero,República Árabe de Yemen,0,1,0,1
2016,Enero,Zambia,1,1,0,2
2016,Enero,Zimbabue,2,6,0,8
2016,Enero,Anguila/Territorio Británico de Ultramar,0,1,0,1
2016,Enero,Desconocido,43,103,0,146
2016,Febrero,Afganistán,0,1,0,1
2016,Febrero,Albania,3,2,0,5
2016,Febrero,Alemania,2392,3458,0,5850
2016,Febrero,Andorra,3,12,0,15
2016,Febrero,Angola,0,1,0,1
2016,Febrero,Antigua y Barbuda,4,8,0,12
2016,Febrero,Países Bajos,1388,2156,0,3544
2016,Febrero,Arabia Saudita,0,8,0,8
2016,Febrero,Argelia,3,4,0,7
2016,Febrero,Argentina,6185,7317,0,13502
2016,Febrero,República de Armenia,2,8,0,10
2016,Febrero,Aruba,1,2,0,3
2016,Febrero,Australia,407,731,0,1138
2016,Febrero,Austria,296,430,0,726
2016,Febrero,Azerbaiyán,1,3,0,4
2016,Febrero,Bahamas,6,6,0,12
2016,Febrero,Bahréin,1,2,0,3
2016,Febrero,Bangladesh,1,2,0,3
2016,Febrero,Barbados,12,14,0,26
2016,Febrero,República de Belarús,29,80,0,109
2016,Febrero,Bélgica,256,515,0,771
2016,Febrero,Belice,5,15,0,20
2016,Febrero,Bermudas/Territorio Británico de Ultramar,1,3,0,4
2016,Febrero,Bolivia,627,729,0,1356
2016,Febrero,Bosnia y Herzegovina,1,0,0,1
2016,Febrero,Brasil,8964,9161,0,18125
2016,Febrero,Bulgaria,50,51,0,101
2016,Febrero,Cabo Verde,2,2,0,4
2016,Febrero,Islas Caimán/Territorio Británico de Ultramar,5,1,0,6
2016,Febrero,Camerún,0,5,0,5
2016,Febrero,Canadá,2261,3054,0,5315
2016,Febrero,España,2734,6340,0,9074
2016,Febrero,República Democrática del Congo,2,2,0,4
2016,Febrero,República de Corea,292,506,0,798
2016,Febrero,Costa de Marfil,0,7,0,7
2016,Febrero,Costa Rica,885,1300,0,2185
2016,Febrero,Croacia,26,60,0,86
2016,Febrero,Cuba,146,265,0,411
2016,Febrero,República Checa,62,127,0,189
2016,Febrero,Chile,6386,6492,0,12878
2016,Febrero,China,354,701,0,1055
2016,Febrero,Chipre,6,4,0,10
2016,Febrero,Dinamarca,210,326,0,536
2016,Febrero,Dominica,0,7,0,7
2016,Febrero,Ecuador,5652,7451,0,13103
2016,Febrero,Egipto,5,35,0,40
2016,Febrero,El Salvador,778,1095,0,1873
2016,Febrero,Emiratos Árabes,5,67,0,72
2016,Febrero,Eslovaquia,26,32,0,58
2016,Febrero,Eslovenia,33,39,0,72
2016,Febrero,Estados Unidos de América,14717,25947,0,40664
2016,Febrero,Estonia,8,13,0,21
2016,Febrero,Etiopia,1,1,0,2
2016,Febrero,Islas Fiji,0,1,0,1
2016,Febrero,Filipinas,128,344,0,472
2016,Febrero,Finlandia,65,93,0,158
2016,Febrero,Francia,2426,3597,0,6023
2016,Febrero,Gabón,0,1,0,1
2016,Febrero,Georgia,2,20,0,22
2016,Febrero,Ghana,1,14,0,15
2016,Febrero,Granada,2,2,0,4
2016,Febrero,Grecia,30,115,0,145
2016,Febrero,Guatemala,484,992,0,1476
2016,Febrero,Guyana,11,7,0,18
2016,Febrero,Haití,3,16,0,19
2016,Febrero,Honduras,283,384,0,667
2016,Febrero,Hong Kong,0,1,0,1
2016,Febrero,Hungría,43,55,0,98
2016,Febrero,India,74,483,0,557
2016,Febrero,Indonesia,13,24,0,37
2016,Febrero,Iraq,0,2,0,2
2016,Febrero,Irán,5,12,0,17
2016,Febrero,República de Irlanda,118,264,0,382
2016,Febrero,Islandia,12,16,0,28
2016,Febrero,Israel,207,703,0,910
2016,Febrero,Italia,1059,2566,0,3625
2016,Febrero,Jamaica,31,43,0,74
2016,Febrero,Japón,320,662,0,982
2016,Febrero,Jordania,1,5,0,6
2016,Febrero,Kazajistán,9,3,0,12
2016,Febrero,Kenia,8,18,0,26
2016,Febrero,Kiribati,0,1,0,1
2016,Febrero,Kuwait,2,5,0,7
2016,Febrero,República de Kosovo,3,2,0,5
2016,Febrero,Letonia,14,30,0,44
2016,Febrero,Lituania,34,35,0,69
2016,Febrero,Líbano,16,13,0,29
2016,Febrero,Liechtenstein,1,2,0,3
2016,Febrero,Luxemburgo,10,12,0,22
2016,Febrero,Macedonia,1,2,0,3
2016,Febrero,Madagascar,3,0,0,3
2016,Febrero,Malasia,33,25,0,58
2016,Febrero,Malí,0,2,0,2
2016,Febrero,Malta,9,23,0,32
2016,Febrero,Marruecos,9,12,0,21
2016,Febrero,Mauricio,0,3,0,3
2016,Febrero,México,3523,7178,0,10701
2016,Febrero,República de Moldavia,2,5,0,7
2016,Febrero,Mónaco,4,0,0,4
2016,Febrero,Mongolia,2,0,0,2
2016,Febrero,Montenegro,1,2,0,3
2016,Febrero,Mozambique,2,0,0,2
2016,Febrero,Myanmar,1,9,0,10
2016,Febrero,Nepal,1,3,0,4
2016,Febrero,Nicaragua,115,115,0,230
2016,Febrero,Nigeria,6,7,0,13
2016,Febrero,Noruega,135,221,0,356
2016,Febrero,Nueva Zelanda,67,132,0,199
2016,Febrero,Omán,0,3,0,3
2016,Febrero,Pakistán,4,20,0,24
2016,Febrero,Panamá,4724,4333,0,9057
2016,Febrero,Paraguay,377,317,0,694
2016,Febrero,Perú,6103,6902,0,13005
2016,Febrero,Palestina,0,5,0,5
2016,Febrero,Polonia,230,333,0,563
2016,Febrero,Portugal,276,654,0,930
2016,Febrero,Reino Unido de Gran Bretaña e Irlanda del Norte,1391,2628,0,4019
2016,Febrero,República CentroÁfricana,0,1,0,1
2016,Febrero,Federación de Rusia,203,278,0,481
2016,Febrero,República Dominicana,495,712,0,1207
2016,Febrero,Rumania,61,99,0,160
2016,Febrero,Rwanda,1,1,0,2
2016,Febrero,San Cristóbal y Nevis,0,2,0,2
2016,Febrero,San Marino,1,2,0,3
2016,Febrero,San  Vicente y las Granadinas,0,1,0,1
2016,Febrero,Santa Lucia,1,5,0,6
2016,Febrero,Santa Sede/Ciudad del Vaticano,0,1,0,1
2016,Febrero,Senegal,0,3,0,3
2016,Febrero,Serbia,10,23,0,33
2016,Febrero,Sierra Leona,2,0,0,2
2016,Febrero,Singapur,13,21,0,34
2016,Febrero,República Árabe Siria,0,2,0,2
2016,Febrero,Sri Lanka,4,2,0,6
2016,Febrero,Sudáfrica,44,150,0,194
2016,Febrero,Sudán,0,2,0,2
2016,Febrero,Suecia,297,432,0,729
2016,Febrero,Suiza,660,985,0,1645
2016,Febrero,Surinam,22,37,0,59
2016,Febrero,Taiwán,73,80,0,153
2016,Febrero,República de Tayikistán,0,2,0,2
2016,Febrero,Tailandia,18,6,0,24
2016,Febrero,Tanzania,2,0,0,2
2016,Febrero,Togo,1,2,0,3
2016,Febrero,Trinidad y Tobago,24,75,0,99
2016,Febrero,Túnez,2,5,0,7
2016,Febrero,Turquía,47,162,0,209
2016,Febrero,Ucrania,26,72,0,98
2016,Febrero,Uganda,2,3,0,5
2016,Febrero,Uruguay,295,497,0,792
2016,Febrero,Uzbekistán,1,2,0,3
2016,Febrero,Venezuela,7632,9835,0,17467
2016,Febrero,Vietnam,4,2,0,6
2016,Febrero,República Árabe de Yemen,0,1,0,1
2016,Febrero,Zambia,1,2,0,3
2016,Febrero,Zimbabue,0,1,0,1
2016,Febrero,Anguila/Territorio Británico de Ultramar,0,1,0,1
2016,Febrero,Desconocido,52,121,0,173
2016,Marzo,Albania,3,4,0,7
2016,Marzo,Alemania,2488,3520,0,6008
2016,Marzo,Andorra,2,15,0,17
2016,Marzo,Antigua y Barbuda,3,10,0,13
2016,Marzo,Países Bajos,1441,2061,0,3502
2016,Marzo,Arabia Saudita,0,25,0,25
2016,Marzo,Argelia,3,6,0,9
2016,Marzo,Argentina,6035,7326,0,13361
2016,Marzo,República de Armenia,3,1,0,4
2016,Marzo,Aruba,1,2,0,3
2016,Marzo,Australia,397,641,0,1038
2016,Marzo,Austria,207,443,0,650
2016,Marzo,Azerbaiyán,2,9,0,11
2016,Marzo,Bahamas,6,7,0,13
2016,Marzo,Bangladesh,0,9,0,9
2016,Marzo,Barbados,14,27,0,41
2016,Marzo,República de Belarús,5,7,0,12
2016,Marzo,Bélgica,267,468,0,735
2016,Marzo,Belice,2,12,0,14
2016,Marzo,Bermudas/Territorio Británico de Ultramar,4,8,0,12
2016,Marzo,Bolivia,647,723,0,1370
2016,Marzo,Bosnia y Herzegovina,0,4,0,4
2016,Marzo,Botsuana,0,2,0,2
2016,Marzo,Brasil,7462,7615,0,15077
2016,Marzo,Brunei Darussalam,0,1,0,1
2016,Marzo,Bulgaria,26,49,0,75
2016,Marzo,Burkina Faso,0,1,0,1
2016,Marzo,Bután,0,2,0,2
2016,Marzo,Cabo Verde,0,3,0,3
2016,Marzo,Islas Caimán/Territorio Británico de Ultramar,2,5,0,7
2016,Marzo,Camerún,1,4,0,5
2016,Marzo,Canadá,2065,2812,0,4877
2016,Marzo,España,3315,6719,0,10034
2016,Marzo,República Democrática del Congo,1,5,0,6
2016,Marzo,República de Corea,268,531,0,799
2016,Marzo,Costa de Marfil,1,2,0,3
2016,Marzo,Costa Rica,1252,1737,0,2989
2016,Marzo,Croacia,19,36,0,55
2016,Marzo,Cuba,165,303,0,468
2016,Marzo,República Checa,59,104,0,163
2016,Marzo,Chile,4180,5317,0,9497
2016,Marzo,China,421,953,0,1374
2016,Marzo,Chipre,6,15,0,21
2016,Marzo,Dinamarca,175,310,0,485
2016,Marzo,Dominica,4,5,0,9
2016,Marzo,Ecuador,6944,9635,0,16579
2016,Marzo,Egipto,2,14,0,16
2016,Marzo,El Salvador,1225,1351,0,2576
2016,Marzo,Emiratos Árabes,1,16,0,17
2016,Marzo,Eslovaquia,28,31,0,59
2016,Marzo,Eslovenia,29,56,0,85
2016,Marzo,Estados Unidos de América,17133,27757,0,44890
2016,Marzo,Estonia,12,8,0,20
2016,Marzo,Etiopia,1,5,0,6
2016,Marzo,Islas Fiji,0,1,0,1
2016,Marzo,Filipinas,40,278,0,318
2016,Marzo,Finlandia,78,129,0,207
2016,Marzo,Francia,1807,2920,0,4727
2016,Marzo,Gambia,1,0,0,1
2016,Marzo,Georgia,2,2,0,4
2016,Marzo,Ghana,1,11,0,12
2016,Marzo,Granada,1,5,0,6
2016,Marzo,Grecia,40,114,0,154
2016,Marzo,Guatemala,870,1191,0,2061
2016,Marzo,Guyana,7,13,0,20
2016,Marzo,Guinea,1,0,0,1
2016,Marzo,Guinea Ecuatorial,0,1,0,1
2016,Marzo,Haití,31,41,0,72
2016,Marzo,Honduras,495,530,0,1025
2016,Marzo,Hong Kong,4,2,0,6
2016,Marzo,Hungría,48,58,0,106
2016,Marzo,India,94,446,0,540
2016,Marzo,Indonesia,9,36,0,45
2016,Marzo,Irán,7,16,0,23
2016,Marzo,República de Irlanda,173,252,0,425
2016,Marzo,Islandia,13,25,0,38
2016,Marzo,Israel,314,1043,0,1357
2016,Marzo,Italia,945,2313,0,3258
2016,Marzo,Jamaica,34,47,0,81
2016,Marzo,Japón,246,590,0,836
2016,Marzo,Jordania,3,12,0,15
2016,Marzo,Kazajistán,8,4,0,12
2016,Marzo,Kenia,3,8,0,11
2016,Marzo,Kirguistán,4,3,0,7
2016,Marzo,Kuwait,0,5,0,5
2016,Marzo,República de Kosovo,1,0,0,1
2016,Marzo,Letonia,9,10,0,19
2016,Marzo,Lituania,28,31,0,59
2016,Marzo,Líbano,10,28,0,38
2016,Marzo,Liberia,1,4,0,5
2016,Marzo,Liechtenstein,1,3,0,4
2016,Marzo,Luxemburgo,7,15,0,22
2016,Marzo,Macedonia,1,3,0,4
2016,Marzo,Madagascar,0,1,0,1
2016,Marzo,Malasia,16,29,0,45
2016,Marzo,Malawi,0,1,0,1
2016,Marzo,Malí,2,5,0,7
2016,Marzo,Malta,5,15,0,20
2016,Marzo,Marruecos,5,20,0,25
2016,Marzo,Mauricio,1,7,0,8
2016,Marzo,México,5299,8738,0,14037
2016,Marzo,República de Moldavia,2,1,0,3
2016,Marzo,Mónaco,3,0,0,3
2016,Marzo,Montenegro,1,2,0,3
2016,Marzo,Mozambique,1,3,0,4
2016,Marzo,Namibia,0,1,0,1
2016,Marzo,Nepal,1,4,0,5
2016,Marzo,Nicaragua,129,128,0,257
2016,Marzo,Nigeria,5,17,0,22
2016,Marzo,Noruega,189,266,0,455
2016,Marzo,Nueva Zelanda,81,117,0,198
2016,Marzo,Omán,1,0,0,1
2016,Marzo,Pakistán,12,16,0,28
2016,Marzo,Panamá,3410,3795,0,7205
2016,Marzo,Paraguay,366,300,0,666
2016,Marzo,Perú,5306,6237,0,11543
2016,Marzo,Palestina,0,1,0,1
2016,Marzo,Polonia,187,235,0,422
2016,Marzo,Portugal,327,659,0,986
2016,Marzo,Reino Unido de Gran Bretaña e Irlanda del Norte,1913,3079,0,4992
2016,Marzo,República CentroÁfricana,1,0,0,1
2016,Marzo,Federación de Rusia,199,301,0,500
2016,Marzo,República Dominicana,743,828,0,1571
2016,Marzo,Rumania,55,97,0,152
2016,Marzo,Rwanda,1,0,0,1
2016,Marzo,San Cristóbal y Nevis,1,4,0,5
2016,Marzo,Samoa Occidental,1,0,0,1
2016,Marzo,San  Vicente y las Granadinas,2,7,0,9
2016,Marzo,Santa Lucia,7,5,0,12
2016,Marzo,Santa Sede/Ciudad del Vaticano,0,1,0,1
2016,Marzo,Senegal,1,1,0,2
2016,Marzo,Serbia,13,16,0,29
2016,Marzo,Sierra Leona,0,2,0,2
2016,Marzo,Singapur,13,26,0,39
2016,Marzo,Sri Lanka,2,4,0,6
2016,Marzo,Sudáfrica,67,93,0,160
2016,Marzo,Sudán,1,3,0,4
2016,Marzo,Suecia,313,461,0,774
2016,Marzo,Suiza,552,860,0,1412
2016,Marzo,Surinam,18,23,0,41
2016,Marzo,Taiwán,85,114,0,199
2016,Marzo,República de Tayikistán,0,1,0,1
2016,Marzo,Tailandia,19,12,0,31
2016,Marzo,Tanzania,2,2,0,4
2016,Marzo,Togo,1,3,0,4
2016,Marzo,Trinidad y Tobago,45,87,0,132
2016,Marzo,Túnez,0,4,0,4
2016,Marzo,Turquía,69,190,0,259
2016,Marzo,Ucrania,17,48,0,65
2016,Marzo,Uganda,1,4,0,5
2016,Marzo,Uruguay,427,695,0,1122
2016,Marzo,Uzbekistán,1,0,0,1
2016,Marzo,Venezuela,8643,10149,0,18792
2016,Marzo,Vietnam,8,2,0,10
2016,Marzo,Islas Vírgenes Británicas/Territorio Británico de Ultramar,1,2,0,3
2016,Marzo,Zimbabue,3,3,0,6
2016,Marzo,Desconocido,94,164,0,258
2016,Abril,Afganistán,0,1,0,1
2016,Abril,Albania,0,7,0,7
2016,Abril,Alemania,1397,2408,0,3805
2016,Abril,Andorra,4,7,0,11
2016,Abril,Angola,0,4,0,4
2016,Abril,Antigua y Barbuda,2,11,0,13
2016,Abril,Países Bajos,1673,2349,0,4022
2016,Abril,Arabia Saudita,0,5,0,5
2016,Abril,Argelia,2,2,0,4
2016,Abril,Argentina,5079,6360,0,11439
2016,Abril,República de Armenia,9,3,0,12
2016,Abril,Aruba,2,0,0,2
2016,Abril,Australia,388,708,0,1096
2016,Abril,Austria,116,246,0,362
2016,Abril,Bahamas,4,10,0,14
2016,Abril,Bangladesh,0,5,0,5
2016,Abril,Barbados,9,15,0,24
2016,Abril,República de Belarús,4,1,0,5
2016,Abril,Bélgica,157,353,0,510
2016,Abril,Belice,2,16,0,18
2016,Abril,Benín,2,1,0,3
2016,Abril,Bermudas/Territorio Británico de Ultramar,1,4,0,5
2016,Abril,Bolivia,600,757,0,1357
2016,Abril,Bosnia y Herzegovina,0,5,0,5
2016,Abril,Botsuana,0,4,0,4
2016,Abril,Brasil,8493,8865,0,17358
2016,Abril,Bulgaria,20,42,0,62
2016,Abril,Burundi,1,4,0,5
2016,Abril,Cabo Verde,3,0,0,3
2016,Abril,Islas Caimán/Territorio Británico de Ultramar,4,2,0,6
2016,Abril,Camboya,0,2,0,2
2016,Abril,Camerún,0,1,0,1
2016,Abril,Canadá,1055,1859,0,2914
2016,Abril,Chad,0,1,0,1
2016,Abril,España,2401,5970,0,8371
2016,Abril,República Democrática del Congo,5,2,0,7
2016,Abril,República de Corea,176,452,0,628
2016,Abril,Costa de Marfil,0,2,0,2
2016,Abril,Costa Rica,1054,1475,0,2529
2016,Abril,Croacia,9,45,0,54
2016,Abril,Cuba,211,376,0,587
2016,Abril,República Checa,63,88,0,151
2016,Abril,Chile,3817,4931,0,8748
2016,Abril,China,351,868,0,1219
2016,Abril,Chipre,1,3,0,4
2016,Abril,Dinamarca,118,201,0,319
2016,Abril,Dominica,3,5,0,8
2016,Abril,Ecuador,5776,7418,0,13194
2016,Abril,Egipto,7,38,0,45
2016,Abril,El Salvador,952,1200,0,2152
2016,Abril,Emiratos Árabes,5,13,0,18
2016,Abril,Eritrea,0,2,0,2
2016,Abril,Eslovaquia,21,41,0,62
2016,Abril,Eslovenia,3,30,0,33
2016,Abril,Estados Unidos de América,13079,24162,0,37241
2016,Abril,Estonia,9,8,0,17
2016,Abril,Etiopia,0,4,0,4
2016,Abril,Islas Fiji,0,1,0,1
2016,Abril,Filipinas,42,339,0,381
2016,Abril,Finlandia,60,91,0,151
2016,Abril,Francia,1688,2799,0,4487
2016,Abril,Gabón,0,2,0,2
2016,Abril,Georgia,1,2,0,3
2016,Abril,Ghana,3,10,0,13
2016,Abril,Granada,2,2,0,4
2016,Abril,Grecia,21,56,0,77
2016,Abril,Guatemala,499,1003,0,1502
2016,Abril,Guyana,11,11,0,22
2016,Abril,Guinea,0,1,0,1
2016,Abril,Haití,9,18,0,27
2016,Abril,Honduras,401,506,0,907
2016,Abril,Hong Kong,1,0,0,1
2016,Abril,Hungría,25,38,0,63
2016,Abril,India,75,447,0,522
2016,Abril,Indonesia,17,29,0,46
2016,Abril,Iraq,1,0,0,1
2016,Abril,Irán,6,14,0,20
2016,Abril,República de Irlanda,150,249,0,399
2016,Abril,Islandia,9,7,0,16
2016,Abril,Israel,576,1494,0,2070
2016,Abril,Italia,687,2030,0,2717
2016,Abril,Jamaica,20,31,0,51
2016,Abril,Islas Salomón,0,1,0,1
2016,Abril,Japón,131,458,0,589
2016,Abril,Jordania,2,7,0,9
2016,Abril,Kazajistán,5,3,0,8
2016,Abril,Kenia,14,16,0,30
2016,Abril,República de Kosovo,0,2,0,2
2016,Abril,Lesoto,2,1,0,3
2016,Abril,Letonia,10,9,0,19
2016,Abril,Lituania,21,14,0,35
2016,Abril,Líbano,14,24,0,38
2016,Abril,Liberia,0,1,0,1
2016,Abril,Liechtenstein,1,1,0,2
2016,Abril,Luxemburgo,5,8,0,13
2016,Abril,Macedonia,2,0,0,2
2016,Abril,Madagascar,1,0,0,1
2016,Abril,Malasia,16,26,0,42
2016,Abril,Malí,1,0,0,1
2016,Abril,Malta,5,6,0,11
2016,Abril,Marruecos,10,8,0,18
2016,Abril,Mauricio,0,4,0,4
2016,Abril,Mauritania,0,1,0,1
2016,Abril,México,4037,7904,0,11941
2016,Abril,República de Moldavia,1,2,0,3
2016,Abril,Montenegro,1,1,0,2
2016,Abril,Mozambique,1,3,0,4
2016,Abril,Myanmar,0,4,0,4
2016,Abril,Nepal,2,2,0,4
2016,Abril,Nicaragua,91,134,0,225
2016,Abril,Nigeria,6,13,0,19
2016,Abril,Noruega,78,173,0,251
2016,Abril,Nueva Zelanda,71,140,0,211
2016,Abril,Pakistán,4,13,0,17
2016,Abril,Panamá,3991,3900,0,7891
2016,Abril,Paraguay,345,257,0,602
2016,Abril,Perú,4353,5518,0,9871
2016,Abril,Palestina,1,5,0,6
2016,Abril,Polonia,128,250,0,378
2016,Abril,Portugal,193,521,0,714
2016,Abril,Qatar,0,1,0,1
2016,Abril,Reino Unido de Gran Bretaña e Irlanda del Norte,1225,2329,0,3554
2016,Abril,República CentroÁfricana,1,1,0,2
2016,Abril,Federación de Rusia,161,239,0,400
2016,Abril,República Dominicana,580,699,0,1279
2016,Abril,Rumania,46,88,0,134
2016,Abril,Rwanda,2,1,0,3
2016,Abril,San Cristóbal y Nevis,0,3,0,3
2016,Abril,Samoa Estadounidense/Territorio no incorporado de Estados Unidos,0,1,0,1
2016,Abril,San Marino,0,1,0,1
2016,Abril,San  Vicente y las Granadinas,0,3,0,3
2016,Abril,Santa Lucia,3,5,0,8
2016,Abril,Senegal,2,6,0,8
2016,Abril,Serbia,11,20,0,31
2016,Abril,Sierra Leona,1,4,0,5
2016,Abril,Singapur,16,23,0,39
2016,Abril,República Árabe Siria,0,5,0,5
2016,Abril,Sri Lanka,1,2,0,3
2016,Abril,Sudáfrica,50,103,0,153
2016,Abril,Suecia,243,353,0,596
2016,Abril,Suiza,486,736,0,1222
2016,Abril,Surinam,24,26,0,50
2016,Abril,Taiwán,40,88,0,128
2016,Abril,República de Tayikistán,0,1,0,1
2016,Abril,Tailandia,20,15,0,35
2016,Abril,Tanzania,0,5,0,5
2016,Abril,Togo,0,3,0,3
2016,Abril,Trinidad y Tobago,30,65,0,95
2016,Abril,Túnez,7,9,0,16
2016,Abril,Turquía,33,164,0,197
2016,Abril,Ucrania,18,55,0,73
2016,Abril,Uganda,5,4,0,9
2016,Abril,Uruguay,324,503,0,827
2016,Abril,Uzbekistán,2,0,0,2
2016,Abril,Venezuela,7336,9066,0,16402
2016,Abril,Vietnam,6,20,0,26
2016,Abril,Zambia,2,4,0,6
2016,Abril,Zimbabue,4,2,0,6
2016,Abril,Desconocido,52,121,0,173
2016,Mayo,Afganistán,0,2,0,2
2016,Mayo,Albania,1,3,0,4
2016,Mayo,Alemania,1410,2409,0,3819
2016,Mayo,Andorra,6,15,0,21
2016,Mayo,Angola,1,1,0,2
2016,Mayo,Antigua y Barbuda,2,8,0,10
2016,Mayo,Países Bajos,1476,2168,0,3644
2016,Mayo,Arabia Saudita,0,24,0,24
2016,Mayo,Argelia,0,2,0,2
2016,Mayo,Argentina,4510,6385,0,10895
2016,Mayo,República de Armenia,1,0,0,1
2016,Mayo,Australia,443,791,0,1234
2016,Mayo,Austria,128,217,0,345
2016,Mayo,Azerbaiyán,3,7,0,10
2016,Mayo,Bahamas,5,13,0,18
2016,Mayo,Bahréin,1,2,0,3
2016,Mayo,Bangladesh,1,3,0,4
2016,Mayo,Barbados,12,27,0,39
2016,Mayo,República de Belarús,1,7,0,8
2016,Mayo,Bélgica,170,406,0,576
2016,Mayo,Belice,8,18,0,26
2016,Mayo,Bermudas/Territorio Británico de Ultramar,1,4,0,5
2016,Mayo,Bolivia,679,741,0,1420
2016,Mayo,Bosnia y Herzegovina,1,2,0,3
2016,Mayo,Botsuana,1,0,0,1
2016,Mayo,Brasil,7327,8088,0,15415
2016,Mayo,Brunei Darussalam,0,1,0,1
2016,Mayo,Bulgaria,27,37,0,64
2016,Mayo,Burkina Faso,1,1,0,2
2016,Mayo,Burundi,1,0,0,1
2016,Mayo,Islas Caimán/Territorio Británico de Ultramar,5,0,0,5
2016,Mayo,Camboya,1,0,0,1
2016,Mayo,Camerún,0,3,0,3
2016,Mayo,Guernsey,0,1,0,1
2016,Mayo,Canadá,1091,1876,0,2967
2016,Mayo,España,2357,5994,0,8351
2016,Mayo,República Democrática del Congo,1,2,0,3
2016,Mayo,Islas Heard Y Mcdonald,1,0,0,1
2016,Mayo,República de Corea,194,514,0,708
2016,Mayo,Costa Rica,1019,1465,0,2484
2016,Mayo,Croacia,11,35,0,46
2016,Mayo,Cuba,202,466,0,668
2016,Mayo,República Checa,68,100,0,168
2016,Mayo,Chile,4352,5527,0,9879
2016,Mayo,China,383,964,0,1347
2016,Mayo,Chipre,2,5,0,7
2016,Mayo,Dinamarca,113,195,0,308
2016,Mayo,Dominica,0,3,0,3
2016,Mayo,Ecuador,4342,6850,0,11192
2016,Mayo,Egipto,5,23,0,28
2016,Mayo,El Salvador,876,1176,0,2052
2016,Mayo,Emiratos Árabes,2,6,0,8
2016,Mayo,Eslovaquia,16,39,0,55
2016,Mayo,Eslovenia,10,30,0,40
2016,Mayo,Estados Unidos de América,13807,24629,0,38436
2016,Mayo,Estonia,13,15,0,28
2016,Mayo,Etiopia,0,5,0,5
2016,Mayo,Filipinas,36,225,0,261
2016,Mayo,Finlandia,54,68,0,122
2016,Mayo,Francia,1443,2592,0,4035
2016,Mayo,Georgia,2,6,0,8
2016,Mayo,Ghana,4,13,0,17
2016,Mayo,Granada,2,2,0,4
2016,Mayo,Grecia,34,72,0,106
2016,Mayo,Guatemala,551,1189,0,1740
2016,Mayo,Guyana,10,14,0,24
2016,Mayo,Guinea Ecuatorial,0,1,0,1
2016,Mayo,Guinea Bissau,1,1,0,2
2016,Mayo,Haití,8,18,0,26
2016,Mayo,Honduras,334,430,0,764
2016,Mayo,Hong Kong,1,6,0,7
2016,Mayo,Hungría,24,41,0,65
2016,Mayo,India,86,534,0,620
2016,Mayo,Indonesia,11,47,0,58
2016,Mayo,Iraq,1,1,0,2
2016,Mayo,Irán,3,7,0,10
2016,Mayo,República de Irlanda,152,298,0,450
2016,Mayo,Islandia,11,19,0,30
2016,Mayo,Israel,478,1233,0,1711
2016,Mayo,Italia,640,1905,0,2545
2016,Mayo,Jamaica,22,38,0,60
2016,Mayo,Islas Salomón,0,1,0,1
2016,Mayo,Japón,146,534,0,680
2016,Mayo,Jordania,3,6,0,9
2016,Mayo,Kazajistán,6,2,0,8
2016,Mayo,Kenia,5,9,0,14
2016,Mayo,Kirguistán,1,0,0,1
2016,Mayo,Kuwait,1,2,0,3
2016,Mayo,República de Kosovo,0,1,0,1
2016,Mayo,Letonia,10,45,0,55
2016,Mayo,Lituania,26,43,0,69
2016,Mayo,Líbano,12,32,0,44
2016,Mayo,Liechtenstein,3,1,0,4
2016,Mayo,Luxemburgo,4,14,0,18
2016,Mayo,Macedonia,1,2,0,3
2016,Mayo,Malasia,17,36,0,53
2016,Mayo,Malta,4,13,0,17
2016,Mayo,Marruecos,4,10,0,14
2016,Mayo,Mauricio,1,2,0,3
2016,Mayo,México,4294,8321,0,12615
2016,Mayo,República de Moldavia,2,0,0,2
2016,Mayo,Mongolia,1,0,0,1
2016,Mayo,Montenegro,0,1,0,1
2016,Mayo,Mozambique,1,1,0,2
2016,Mayo,Myanmar,0,1,0,1
2016,Mayo,Namibia,1,0,0,1
2016,Mayo,Nepal,2,2,0,4
2016,Mayo,Nicaragua,67,126,0,193
2016,Mayo,Nigeria,7,20,0,27
2016,Mayo,Noruega,83,153,0,236
2016,Mayo,Nueva Zelanda,124,190,0,314
2016,Mayo,Pakistán,7,18,0,25
2016,Mayo,Panamá,2794,3067,0,5861
2016,Mayo,Paraguay,259,227,0,486
2016,Mayo,Perú,4667,5968,0,10635
2016,Mayo,Palestina,0,1,0,1
2016,Mayo,Polonia,112,169,0,281
2016,Mayo,Portugal,185,478,0,663
2016,Mayo,Reino Unido de Gran Bretaña e Irlanda del Norte,1254,2371,0,3625
2016,Mayo,República CentroÁfricana,5,0,0,5
2016,Mayo,Federación de Rusia,155,226,0,381
2016,Mayo,República Dominicana,426,678,0,1104
2016,Mayo,Rumania,63,100,0,163
2016,Mayo,Rwanda,1,3,0,4
2016,Mayo,San Cristóbal y Nevis,0,5,0,5
2016,Mayo,Samoa Estadounidense/Territorio no incorporado de Estados Unidos,0,1,0,1
2016,Mayo,San  Vicente y las Granadinas,2,4,0,6
2016,Mayo,Santa Lucia,1,4,0,5
2016,Mayo,Santa Sede/Ciudad del Vaticano,0,2,0,2
2016,Mayo,Senegal,1,3,0,4
2016,Mayo,Serbia,7,18,0,25
2016,Mayo,Sierra Leona,0,1,0,1
2016,Mayo,Singapur,20,37,0,57
2016,Mayo,República Árabe Siria,1,3,0,4
2016,Mayo,Sri Lanka,2,12,0,14
2016,Mayo,Sudáfrica,46,93,0,139
2016,Mayo,Sudán,1,1,0,2
2016,Mayo,Suecia,174,288,0,462
2016,Mayo,Suiza,399,717,0,1116
2016,Mayo,Surinam,20,46,0,66
2016,Mayo,Taiwán,56,111,0,167
2016,Mayo,República de Tayikistán,1,0,0,1
2016,Mayo,Tailandia,11,16,0,27
2016,Mayo,Trinidad y Tobago,15,82,0,97
2016,Mayo,Túnez,2,9,0,11
2016,Mayo,Turquía,173,392,0,565
2016,Mayo,Ucrania,24,33,0,57
2016,Mayo,Uganda,1,1,0,2
2016,Mayo,Uruguay,364,565,0,929
2016,Mayo,Uzbekistán,1,1,0,2
2016,Mayo,Venezuela,7625,9741,0,17366
2016,Mayo,Vietnam,5,3,0,8
2016,Mayo,Islas Vírgenes Británicas/Territorio Británico de Ultramar,0,1,0,1
2016,Mayo,República Árabe de Yemen,0,2,0,2
2016,Mayo,Zambia,1,3,0,4
2016,Mayo,Zimbabue,1,8,0,9
2016,Mayo,Islas Turcas y Caicos/Territorio Británico de Ultramar,0,1,0,1
2016,Mayo,Desconocido,69,128,0,197
2016,Junio,Albania,1,2,0,3
2016,Junio,Alemania,1383,2203,0,3586
2016,Junio,Andorra,1,9,0,10
2016,Junio,Angola,0,2,0,2
2016,Junio,Antigua y Barbuda,2,7,0,9
2016,Junio,Países Bajos,1335,1929,0,3264
2016,Junio,Arabia Saudita,0,5,0,5
2016,Junio,Argelia,1,4,0,5
2016,Junio,Argentina,3643,5548,0,9191
2016,Junio,Aruba,0,1,0,1
2016,Junio,Australia,456,708,0,1164
2016,Junio,Austria,127,216,0,343
2016,Junio,Azerbaiyán,2,0,0,2
2016,Junio,Bahamas,10,13,0,23
2016,Junio,Bahréin,1,1,0,2
2016,Junio,Bangladesh,1,1,0,2
2016,Junio,Barbados,10,17,0,27
2016,Junio,República de Belarús,5,7,0,12
2016,Junio,Bélgica,291,501,0,792
2016,Junio,Belice,8,13,0,21
2016,Junio,Bermudas/Territorio Británico de Ultramar,0,3,0,3
2016,Junio,Bolivia,786,855,0,1641
2016,Junio,Bosnia y Herzegovina,1,0,0,1
2016,Junio,Botsuana,1,0,0,1
2016,Junio,Brasil,5359,6908,0,12267
2016,Junio,Bulgaria,19,28,0,47
2016,Junio,Burkina Faso,0,1,0,1
2016,Junio,Cabo Verde,1,0,0,1
2016,Junio,Islas Caimán/Territorio Británico de Ultramar,2,4,0,6
2016,Junio,Camerún,2,2,0,4
2016,Junio,Canadá,1033,1802,0,2835
2016,Junio,Chad,0,1,0,1
2016,Junio,España,3062,6507,0,9569
2016,Junio,República Democrática del Congo,0,5,0,5
2016,Junio,República de Corea,258,536,0,794
2016,Junio,Costa de Marfil,2,1,0,3
2016,Junio,Costa Rica,1175,1546,0,2721
2016,Junio,Croacia,14,49,0,63
2016,Junio,Cuba,184,403,0,587
2016,Junio,República Checa,50,87,0,137
2016,Junio,Chile,4230,5741,0,9971
2016,Junio,China,367,886,0,1253
2016,Junio,Chipre,2,3,0,5
2016,Junio,Dinamarca,151,229,0,380
2016,Junio,Dominica,3,2,0,5
2016,Junio,Ecuador,4376,6631,0,11007
2016,Junio,Egipto,5,22,0,27
2016,Junio,El Salvador,907,1195,0,2102
2016,Junio,Emiratos Árabes,1,1,0,2
2016,Junio,Eritrea,0,1,0,1
2016,Junio,Eslovaquia,18,29,0,47
2016,Junio,Eslovenia,18,30,0,48
2016,Junio,Estados Unidos de América,21673,31263,0,52936
2016,Junio,Estonia,9,12,0,21
2016,Junio,Etiopia,1,13,0,14
2016,Junio,Filipinas,38,243,0,281
2016,Junio,Finlandia,48,85,0,133
2016,Junio,Francia,1525,2507,0,4032
2016,Junio,Georgia,1,7,0,8
2016,Junio,Ghana,2,3,0,5
2016,Junio,Granada,1,5,0,6
2016,Junio,Grecia,25,83,0,108
2016,Junio,Guatemala,697,1181,0,1878
2016,Junio,Guyana,3,18,0,21
2016,Junio,Guinea Ecuatorial,1,0,0,1
2016,Junio,Haití,9,31,0,40
2016,Junio,Honduras,327,446,0,773
2016,Junio,Hong Kong,2,6,0,8
2016,Junio,Hungría,23,54,0,77
2016,Junio,India,96,483,0,579
2016,Junio,Indonesia,10,22,0,32
2016,Junio,Iraq,0,2,0,2
2016,Junio,Irán,5,16,0,21
2016,Junio,República de Irlanda,131,235,0,366
2016,Junio,Islandia,10,9,0,19
2016,Junio,Israel,285,768,0,1053
2016,Junio,Italia,730,2079,0,2809
2016,Junio,Jamaica,18,69,0,87
2016,Junio,Islas Salomón,1,0,0,1
2016,Junio,Japón,133,480,0,613
2016,Junio,Jordania,3,4,0,7
2016,Junio,Kazajistán,22,13,0,35
2016,Junio,Kenia,5,15,0,20
2016,Junio,Kiribati,0,1,0,1
2016,Junio,Kirguistán,0,1,0,1
2016,Junio,Kuwait,1,0,0,1
2016,Junio,República de Kosovo,0,1,0,1
2016,Junio,Lesoto,0,1,0,1
2016,Junio,Letonia,12,20,0,32
2016,Junio,Lituania,25,34,0,59
2016,Junio,Líbano,9,17,0,26
2016,Junio,Libia,0,1,0,1
2016,Junio,Liechtenstein,3,1,0,4
2016,Junio,Luxemburgo,3,12,0,15
2016,Junio,Macedonia,0,4,0,4
2016,Junio,Madagascar,3,0,0,3
2016,Junio,Malasia,22,34,0,56
2016,Junio,Malta,9,14,0,23
2016,Junio,Marruecos,6,6,0,12
2016,Junio,Mauricio,1,4,0,5
2016,Junio,México,5246,9021,0,14267
2016,Junio,República de Moldavia,5,0,0,5
2016,Junio,Montenegro,0,1,0,1
2016,Junio,Myanmar,1,3,0,4
2016,Junio,Namibia,1,2,0,3
2016,Junio,Nepal,1,1,0,2
2016,Junio,Nicaragua,148,139,0,287
2016,Junio,Nigeria,4,17,0,21
2016,Junio,Noruega,191,267,0,458
2016,Junio,Nueva Zelanda,97,154,0,251
2016,Junio,Omán,0,2,0,2
2016,Junio,Pakistán,5,20,0,25
2016,Junio,Panamá,3851,3631,0,7482
2016,Junio,Paraguay,343,285,0,628
2016,Junio,Perú,5841,7649,0,13490
2016,Junio,Palestina,2,1,0,3
2016,Junio,Polonia,107,195,0,302
2016,Junio,Portugal,150,394,0,544
2016,Junio,Reino Unido de Gran Bretaña e Irlanda del Norte,1243,2196,0,3439
2016,Junio,República CentroÁfricana,2,0,0,2
2016,Junio,Federación de Rusia,128,217,0,345
2016,Junio,República Dominicana,582,742,0,1324
2016,Junio,Rumania,54,73,0,127
2016,Junio,Rwanda,1,7,0,8
2016,Junio,San Cristóbal y Nevis,1,3,0,4
2016,Junio,San Marino,1,0,0,1
2016,Junio,San  Vicente y las Granadinas,2,2,0,4
2016,Junio,Santa Lucia,5,8,0,13
2016,Junio,Santa Sede/Ciudad del Vaticano,0,2,0,2
2016,Junio,Senegal,1,1,0,2
2016,Junio,Serbia,4,5,0,9
2016,Junio,Singapur,13,29,0,42
2016,Junio,República Árabe Siria,5,2,0,7
2016,Junio,Sri Lanka,4,5,0,9
2016,Junio,Sudáfrica,49,107,0,156
2016,Junio,Suecia,295,424,0,719
2016,Junio,Suiza,487,708,0,1195
2016,Junio,Surinam,12,35,0,47
2016,Junio,Taiwán,87,89,0,176
2016,Junio,Tailandia,17,9,0,26
2016,Junio,Tanzania,1,3,0,4
2016,Junio,Trinidad y Tobago,25,65,0,90
2016,Junio,Túnez,3,4,0,7
2016,Junio,Turquía,162,342,0,504
2016,Junio,Ucrania,24,61,0,85
2016,Junio,Uruguay,408,613,0,1021
2016,Junio,Uzbekistán,1,0,0,1
2016,Junio,Venezuela,8237,10313,0,18550
2016,Junio,Vietnam,4,10,0,14
2016,Junio,República Árabe de Yemen,0,1,0,1
2016,Junio,Zambia,1,2,0,3
2016,Junio,Zimbabue,0,3,0,3
2016,Junio,Desconocido,80,168,0,248
2016,Julio,Albania,3,4,0,7
2016,Julio,Alemania,2472,3110,0,5582
2016,Julio,Andorra,1,12,0,13
2016,Julio,Angola,1,1,0,2
2016,Julio,Antigua y Barbuda,0,4,0,4
2016,Julio,Países Bajos,2846,3435,0,6281
2016,Julio,Arabia Saudita,1,16,0,17
2016,Julio,Argelia,1,5,0,6
2016,Julio,Argentina,5233,6415,0,11648
2016,Julio,República de Armenia,0,1,0,1
2016,Julio,Australia,511,791,0,1302
2016,Julio,Austria,274,353,0,627
2016,Julio,Azerbaiyán,0,3,0,3
2016,Julio,Bahamas,14,12,0,26
2016,Julio,Bahréin,2,0,0,2
2016,Julio,Bangladesh,1,3,0,4
2016,Julio,Barbados,16,24,0,40
2016,Julio,República de Belarús,7,8,0,15
2016,Julio,Bélgica,532,735,0,1267
2016,Julio,Belice,15,24,0,39
2016,Julio,Benín,1,2,0,3
2016,Julio,Bermudas/Territorio Británico de Ultramar,0,3,0,3
2016,Julio,Bolivia,890,917,0,1807
2016,Julio,Bosnia y Herzegovina,2,4,0,6
2016,Julio,Botsuana,1,0,0,1
2016,Julio,Brasil,6826,7627,0,14453
2016,Julio,Bulgaria,20,26,0,46
2016,Julio,Burkina Faso,0,5,0,5
2016,Julio,Cabo Verde,4,0,0,4
2016,Julio,Islas Caimán/Territorio Británico de Ultramar,6,5,0,11
2016,Julio,Camboya,1,4,0,5
2016,Julio,Camerún,0,3,0,3
2016,Julio,Canadá,1524,2130,0,3654
2016,Julio,España,3664,6810,0,10474
2016,Julio,República Democrática del Congo,5,4,0,9
2016,Julio,República de Corea,276,483,0,759
2016,Julio,Costa de Marfil,1,0,0,1
2016,Julio,Costa Rica,1712,1975,0,3687
2016,Julio,Croacia,9,44,0,53
2016,Julio,Cuba,263,453,0,716
2016,Julio,República Checa,50,57,0,107
2016,Julio,Chile,5431,6009,0,11440
2016,Julio,China,398,820,0,1218
2016,Julio,Chipre,4,7,0,11
2016,Julio,Dinamarca,205,284,0,489
2016,Julio,Dominica,1,5,0,6
2016,Julio,Ecuador,6662,8759,0,15421
2016,Julio,Egipto,8,35,0,43
2016,Julio,El Salvador,1095,1271,0,2366
2016,Julio,Emiratos Árabes,6,22,0,28
2016,Julio,Eritrea,1,2,0,3
2016,Julio,Eslovaquia,27,28,0,55
2016,Julio,Eslovenia,25,36,0,61
2016,Julio,Estados Unidos de América,21440,30326,0,51766
2016,Julio,Estonia,15,25,0,40
2016,Julio,Etiopia,3,3,0,6
2016,Julio,Islas Fiji,1,0,0,1
2016,Julio,Filipinas,55,252,0,307
2016,Julio,Finlandia,56,64,0,120
2016,Julio,Francia,2924,3980,0,6904
2016,Julio,Gabón,0,2,0,2
2016,Julio,Georgia,6,6,0,12
2016,Julio,Ghana,0,14,0,14
2016,Julio,Granada,2,2,0,4
2016,Julio,Grecia,42,76,0,118
2016,Julio,Guatemala,558,1114,0,1672
2016,Julio,Guyana,13,14,0,27
2016,Julio,Guinea,1,0,0,1
2016,Julio,Guinea Ecuatorial,0,1,0,1
2016,Julio,Haití,15,33,0,48
2016,Julio,Honduras,419,569,0,988
2016,Julio,Hong Kong,5,13,0,18
2016,Julio,Hungría,38,52,0,90
2016,Julio,India,82,493,0,575
2016,Julio,Indonesia,19,30,0,49
2016,Julio,Irán,7,18,0,25
2016,Julio,República de Irlanda,194,289,0,483
2016,Julio,Islandia,4,9,0,13
2016,Julio,Isla de Man,1,0,0,1
2016,Julio,Israel,292,803,0,1095
2016,Julio,Italia,958,2039,0,2997
2016,Julio,Jamaica,38,41,0,79
2016,Julio,Japón,214,585,0,799
2016,Julio,Jordania,2,5,0,7
2016,Julio,Kazajistán,3,0,0,3
2016,Julio,Kenia,13,19,0,32
2016,Julio,Kuwait,3,7,0,10
2016,Julio,República de Kosovo,0,1,0,1
2016,Julio,República Democrática Popular  Lao,0,1,0,1
2016,Julio,Letonia,8,19,0,27
2016,Julio,Lituania,34,33,0,67
2016,Julio,Líbano,25,34,0,59
2016,Julio,Liechtenstein,2,5,0,7
2016,Julio,Luxemburgo,19,22,0,41
2016,Julio,Macedonia,1,3,0,4
2016,Julio,Madagascar,1,0,0,1
2016,Julio,Malasia,14,16,0,30
2016,Julio,Malta,5,13,0,18
2016,Julio,Marruecos,13,23,0,36
2016,Julio,Mauricio,2,4,0,6
2016,Julio,Mauritania,1,1,0,2
2016,Julio,México,6781,9793,0,16574
2016,Julio,Mónaco,3,3,0,6
2016,Julio,Mongolia,3,0,0,3
2016,Julio,Montenegro,1,1,0,2
2016,Julio,Mozambique,1,1,0,2
2016,Julio,Myanmar,2,3,0,5
2016,Julio,Nepal,1,2,0,3
2016,Julio,Nicaragua,102,141,0,243
2016,Julio,Nigeria,4,6,0,10
2016,Julio,Noruega,184,260,0,444
2016,Julio,Nueva Zelanda,117,176,0,293
2016,Julio,Omán,0,2,0,2
2016,Julio,Pakistán,1,11,0,12
2016,Julio,Panamá,3356,3524,0,6880
2016,Julio,Paraguay,241,259,0,500
2016,Julio,Perú,6441,7110,0,13551
2016,Julio,Palestina,3,0,0,3
2016,Julio,Polonia,168,238,0,406
2016,Julio,Portugal,193,458,0,651
2016,Julio,Qatar,1,89,0,90
2016,Julio,Reino Unido de Gran Bretaña e Irlanda del Norte,1779,2750,0,4529
2016,Julio,Federación de Rusia,178,200,0,378
2016,Julio,República Dominicana,734,964,0,1698
2016,Julio,Rumania,60,79,0,139
2016,Julio,San Cristóbal y Nevis,1,2,0,3
2016,Julio,Samoa Estadounidense/Territorio no incorporado de Estados Unidos,0,1,0,1
2016,Julio,San  Vicente y las Granadinas,1,1,0,2
2016,Julio,Santa Lucia,1,4,0,5
2016,Julio,Santo Tomé y Príncipe,0,1,0,1
2016,Julio,Senegal,1,1,0,2
2016,Julio,Serbia,9,13,0,22
2016,Julio,Singapur,20,21,0,41
2016,Julio,República Árabe Siria,0,1,0,1
2016,Julio,Somalia,0,1,0,1
2016,Julio,Sri Lanka,1,6,0,7
2016,Julio,Sudáfrica,56,92,0,148
2016,Julio,Suecia,216,290,0,506
2016,Julio,Suiza,1002,1334,0,2336
2016,Julio,Surinam,10,19,0,29
2016,Julio,Taiwán,81,109,0,190
2016,Julio,Tailandia,27,10,0,37
2016,Julio,Togo,0,1,0,1
2016,Julio,Trinidad y Tobago,60,79,0,139
2016,Julio,Túnez,1,4,0,5
2016,Julio,Turquía,204,339,0,543
2016,Julio,Ucrania,28,35,0,63
2016,Julio,Uganda,1,0,0,1
2016,Julio,Uruguay,412,565,0,977
2016,Julio,Uzbekistán,1,0,0,1
2016,Julio,Venezuela,12409,14126,0,26535
2016,Julio,Vietnam,23,24,0,47
2016,Julio,Islas Vírgenes Británicas/Territorio Británico de Ultramar,1,1,0,2
2016,Julio,Zimbabue,1,2,0,3
2016,Julio,Anguila/Territorio Británico de Ultramar,0,1,0,1
2016,Julio,Desconocido,58,140,0,198
2016,Agosto,Albania,3,6,0,9
2016,Agosto,Alemania,2617,3257,0,5874
2016,Agosto,Andorra,3,8,0,11
2016,Agosto,Angola,1,2,0,3
2016,Agosto,Antigua y Barbuda,0,8,0,8
2016,Agosto,Países Bajos,1689,2382,0,4071
2016,Agosto,Arabia Saudita,2,13,0,15
2016,Agosto,Argelia,2,9,0,11
2016,Agosto,Argentina,4767,7034,0,11801
2016,Agosto,República de Armenia,2,1,0,3
2016,Agosto,Australia,488,781,0,1269
2016,Agosto,Austria,199,310,0,509
2016,Agosto,Azerbaiyán,1,3,0,4
2016,Agosto,Bahamas,10,24,0,34
2016,Agosto,Bahréin,1,0,0,1
2016,Agosto,Bangladesh,1,3,0,4
2016,Agosto,Barbados,53,37,0,90
2016,Agosto,República de Belarús,6,6,0,12
2016,Agosto,Bélgica,291,487,0,778
2016,Agosto,Belice,12,15,0,27
2016,Agosto,Benín,0,1,0,1
2016,Agosto,Bermudas/Territorio Británico de Ultramar,0,1,0,1
2016,Agosto,Bolivia,595,718,0,1313
2016,Agosto,Bosnia y Herzegovina,2,2,0,4
2016,Agosto,Brasil,6005,7169,0,13174
2016,Agosto,Bulgaria,17,25,0,42
2016,Agosto,Burkina Faso,0,3,0,3
2016,Agosto,Islas Caimán/Territorio Británico de Ultramar,16,15,0,31
2016,Agosto,Camboya,1,1,0,2
2016,Agosto,Camerún,0,4,0,4
2016,Agosto,Canadá,1224,1980,0,3204
2016,Agosto,Chad,0,1,0,1
2016,Agosto,España,4309,7354,0,11663
2016,Agosto,República Del Congo,1,5,0,6
2016,Agosto,República Democrática del Congo,0,5,0,5
2016,Agosto,República de Corea,204,474,0,678
2016,Agosto,Costa Rica,1350,1961,0,3311
2016,Agosto,Croacia,10,56,0,66
2016,Agosto,Cuba,243,459,0,702
2016,Agosto,República Checa,41,53,0,94
2016,Agosto,Chile,5757,6600,0,12357
2016,Agosto,China,417,994,0,1411
2016,Agosto,Chipre,1,10,0,11
2016,Agosto,Dinamarca,84,172,0,256
2016,Agosto,Dominica,0,5,0,5
2016,Agosto,Ecuador,9423,11183,0,20606
2016,Agosto,Egipto,13,23,0,36
2016,Agosto,El Salvador,1427,1565,0,2992
2016,Agosto,Emiratos Árabes,2,14,0,16
2016,Agosto,Eritrea,0,1,0,1
2016,Agosto,Eslovaquia,21,21,0,42
2016,Agosto,Eslovenia,15,11,0,26
2016,Agosto,Estados Unidos de América,16375,27326,0,43701
2016,Agosto,Estonia,9,12,0,21
2016,Agosto,Etiopia,1,7,0,8
2016,Agosto,Islas Fiji,3,0,0,3
2016,Agosto,Filipinas,53,261,0,314
2016,Agosto,Finlandia,44,68,0,112
2016,Agosto,Francia,2496,3686,0,6182
2016,Agosto,Gambia,0,1,0,1
2016,Agosto,Georgia,4,3,0,7
2016,Agosto,Ghana,0,4,0,4
2016,Agosto,Granada,1,3,0,4
2016,Agosto,Grecia,47,81,0,128
2016,Agosto,Guatemala,760,1455,0,2215
2016,Agosto,Guyana,11,16,0,27
2016,Agosto,Guinea,0,1,0,1
2016,Agosto,Guinea Ecuatorial,2,1,0,3
2016,Agosto,Haití,8,24,0,32
2016,Agosto,Honduras,373,546,0,919
2016,Agosto,Hong Kong,4,9,0,13
2016,Agosto,Hungría,38,42,0,80
2016,Agosto,India,88,533,0,621
2016,Agosto,Indonesia,13,25,0,38
2016,Agosto,Iraq,0,2,0,2
2016,Agosto,Irán,6,20,0,26
2016,Agosto,República de Irlanda,188,238,0,426
2016,Agosto,Islandia,4,3,0,7
2016,Agosto,Israel,285,826,0,1111
2016,Agosto,Italia,1431,3018,0,4449
2016,Agosto,Islas Christmas,0,1,0,1
2016,Agosto,Jamaica,33,73,0,106
2016,Agosto,Islas Salomón,0,2,0,2
2016,Agosto,Japón,228,495,0,723
2016,Agosto,Jordania,2,8,0,10
2016,Agosto,Kazajistán,5,4,0,9
2016,Agosto,Kenia,11,10,0,21
2016,Agosto,Kuwait,0,8,0,8
2016,Agosto,República de Kosovo,1,1,0,2
2016,Agosto,Lesoto,2,1,0,3
2016,Agosto,Letonia,5,15,0,20
2016,Agosto,Lituania,23,28,0,51
2016,Agosto,Líbano,33,31,0,64
2016,Agosto,Liberia,2,0,0,2
2016,Agosto,Liechtenstein,1,1,0,2
2016,Agosto,Luxemburgo,14,23,0,37
2016,Agosto,Macedonia,1,2,0,3
2016,Agosto,Madagascar,1,0,0,1
2016,Agosto,Malasia,12,20,0,32
2016,Agosto,Malta,6,9,0,15
2016,Agosto,Marruecos,17,26,0,43
2016,Agosto,Mauricio,0,3,0,3
2016,Agosto,México,5383,9428,0,14811
2016,Agosto,República de Moldavia,3,1,0,4
2016,Agosto,Mónaco,0,1,0,1
2016,Agosto,Mongolia,0,1,0,1
2016,Agosto,Montenegro,0,1,0,1
2016,Agosto,Mozambique,2,3,0,5
2016,Agosto,Myanmar,0,4,0,4
2016,Agosto,Nepal,0,6,0,6
2016,Agosto,Nicaragua,147,163,0,310
2016,Agosto,Nigeria,4,19,0,23
2016,Agosto,Níger,1,0,0,1
2016,Agosto,Noruega,76,150,0,226
2016,Agosto,Nueva Zelanda,107,176,0,283
2016,Agosto,Omán,0,1,0,1
2016,Agosto,Pakistán,5,8,0,13
2016,Agosto,Panamá,4014,4276,0,8290
2016,Agosto,Paraguay,302,319,0,621
2016,Agosto,Perú,6066,7136,0,13202
2016,Agosto,Palestina,3,3,0,6
2016,Agosto,Polonia,139,206,0,345
2016,Agosto,Portugal,302,542,0,844
2016,Agosto,Qatar,0,4,0,4
2016,Agosto,Reino Unido de Gran Bretaña e Irlanda del Norte,1370,2270,0,3640
2016,Agosto,República CentroÁfricana,5,0,0,5
2016,Agosto,Federación de Rusia,164,227,0,391
2016,Agosto,República Dominicana,944,1149,0,2093
2016,Agosto,Rumania,42,67,0,109
2016,Agosto,San Cristóbal y Nevis,0,3,0,3
2016,Agosto,Samoa Estadounidense/Territorio no incorporado de Estados Unidos,0,1,0,1
2016,Agosto,Samoa Occidental,1,0,0,1
2016,Agosto,San Marino,0,1,0,1
2016,Agosto,San  Vicente y las Granadinas,2,3,0,5
2016,Agosto,Santa Lucia,2,7,0,9
2016,Agosto,Santa Sede/Ciudad del Vaticano,0,3,0,3
2016,Agosto,Senegal,6,1,0,7
2016,Agosto,Serbia,17,13,0,30
2016,Agosto,Singapur,19,26,0,45
2016,Agosto,República Árabe Siria,1,2,0,3
2016,Agosto,Sri Lanka,4,8,0,12
2016,Agosto,Sudáfrica,43,85,0,128
2016,Agosto,Sudán,0,2,0,2
2016,Agosto,Suecia,158,250,0,408
2016,Agosto,Suiza,536,700,0,1236
2016,Agosto,Surinam,41,42,0,83
2016,Agosto,Suazilandia,0,1,0,1
2016,Agosto,Taiwán,50,83,0,133
2016,Agosto,República de Tayikistán,0,1,0,1
2016,Agosto,Tailandia,14,13,0,27
2016,Agosto,Tanzania,0,1,0,1
2016,Agosto,Togo,1,1,0,2
2016,Agosto,Trinidad y Tobago,50,91,0,141
2016,Agosto,Túnez,3,3,0,6
2016,Agosto,Turkmenistán,1,0,0,1
2016,Agosto,Turquía,150,291,0,441
2016,Agosto,Ucrania,25,41,0,66
2016,Agosto,Uganda,0,1,0,1
2016,Agosto,Uruguay,433,718,0,1151
2016,Agosto,Uzbekistán,0,1,0,1
2016,Agosto,Vanuatu,1,0,0,1
2016,Agosto,Venezuela,28879,31072,0,59951
2016,Agosto,Vietnam,1,1,0,2
2016,Agosto,Zambia,0,2,0,2
2016,Agosto,Zimbabue,1,1,0,2
2016,Agosto,Anguila/Territorio Británico de Ultramar,0,1,0,1
2016,Agosto,Desconocido,74,149,0,223
2016,Septiembre,Albania,3,3,0,6
2016,Septiembre,Alemania,1810,2803,0,4613
2016,Septiembre,Andorra,2,10,0,12
2016,Septiembre,Angola,18,3,0,21
2016,Septiembre,Antigua y Barbuda,2,4,0,6
2016,Septiembre,Países Bajos,1450,2138,0,3588
2016,Septiembre,Arabia Saudita,0,6,0,6
2016,Septiembre,Argelia,2,4,0,6
2016,Septiembre,Argentina,4230,5890,0,10120
2016,Septiembre,República de Armenia,1,0,0,1
2016,Septiembre,Australia,454,708,0,1162
2016,Septiembre,Austria,131,262,0,393
2016,Septiembre,Azerbaiyán,2,28,0,30
2016,Septiembre,Bahamas,14,27,0,41
2016,Septiembre,Bahréin,5,1,0,6
2016,Septiembre,Bangladesh,1,4,0,5
2016,Septiembre,Barbados,9,15,0,24
2016,Septiembre,República de Belarús,7,6,0,13
2016,Septiembre,Bélgica,255,516,0,771
2016,Septiembre,Belice,11,14,0,25
2016,Septiembre,Benín,1,1,0,2
2016,Septiembre,Bermudas/Territorio Británico de Ultramar,2,3,0,5
2016,Septiembre,Bolivia,860,951,0,1811
2016,Septiembre,Bosnia y Herzegovina,0,4,0,4
2016,Septiembre,Botsuana,0,1,0,1
2016,Septiembre,Brasil,7193,7775,0,14968
2016,Septiembre,Bulgaria,25,31,0,56
2016,Septiembre,Burkina Faso,0,3,0,3
2016,Septiembre,Bután,0,1,0,1
2016,Septiembre,Islas Caimán/Territorio Británico de Ultramar,5,7,0,12
2016,Septiembre,Camerún,1,1,0,2
2016,Septiembre,Canadá,851,1622,0,2473
2016,Septiembre,España,3026,6726,0,9752
2016,Septiembre,República Del Congo,0,1,0,1
2016,Septiembre,República Democrática del Congo,2,3,0,5
2016,Septiembre,República de Corea,170,504,0,674
2016,Septiembre,Costa de Marfil,0,3,0,3
2016,Septiembre,Costa Rica,1331,1771,0,3102
2016,Septiembre,Croacia,10,34,0,44
2016,Septiembre,Cuba,250,740,0,990
2016,Septiembre,República Checa,45,98,0,143
2016,Septiembre,Chile,4726,5692,0,10418
2016,Septiembre,China,393,1026,0,1419
2016,Septiembre,Chipre,4,4,0,8
2016,Septiembre,Dinamarca,98,203,0,301
2016,Septiembre,República de Yibuti,0,2,0,2
2016,Septiembre,Dominica,2,7,0,9
2016,Septiembre,Ecuador,5488,7837,0,13325
2016,Septiembre,Egipto,7,48,0,55
2016,Septiembre,El Salvador,1019,1281,0,2300
2016,Septiembre,Emiratos Árabes,2,9,0,11
2016,Septiembre,Eslovaquia,18,34,0,52
2016,Septiembre,Eslovenia,16,27,0,43
2016,Septiembre,Estados Unidos de América,11036,21905,0,32941
2016,Septiembre,Estonia,10,11,0,21
2016,Septiembre,Etiopia,0,2,0,2
2016,Septiembre,Islas Fiji,0,2,0,2
2016,Septiembre,Filipinas,46,236,0,282
2016,Septiembre,Finlandia,45,57,0,102
2016,Septiembre,Francia,1316,2338,0,3654
2016,Septiembre,Georgia,0,12,0,12
2016,Septiembre,Ghana,2,7,0,9
2016,Septiembre,Granada,2,3,0,5
2016,Septiembre,Grecia,27,94,0,121
2016,Septiembre,Guatemala,810,1389,0,2199
2016,Septiembre,Guyana,15,17,0,32
2016,Septiembre,Guinea Ecuatorial,0,1,0,1
2016,Septiembre,Guinea Bissau,2,0,0,2
2016,Septiembre,Haití,9,18,0,27
2016,Septiembre,Honduras,444,534,0,978
2016,Septiembre,Hong Kong,13,17,0,30
2016,Septiembre,Hungría,30,60,0,90
2016,Septiembre,India,77,526,0,603
2016,Septiembre,Indonesia,13,27,0,40
2016,Septiembre,Iraq,0,2,0,2
2016,Septiembre,Irán,10,65,0,75
2016,Septiembre,República de Irlanda,147,264,0,411
2016,Septiembre,Islandia,10,11,0,21
2016,Septiembre,Israel,160,630,0,790
2016,Septiembre,Italia,721,2198,0,2919
2016,Septiembre,Jamaica,31,55,0,86
2016,Septiembre,Islas Salomón,0,20,0,20
2016,Septiembre,Japón,213,644,0,857
2016,Septiembre,Jordania,4,6,0,10
2016,Septiembre,Kazajistán,4,33,0,37
2016,Septiembre,Kenia,9,12,0,21
2016,Septiembre,Kirguistán,0,2,0,2
2016,Septiembre,Kuwait,1,2,0,3
2016,Septiembre,República de Kosovo,1,2,0,3
2016,Septiembre,República Democrática Popular  Lao,1,2,0,3
2016,Septiembre,Letonia,7,10,0,17
2016,Septiembre,Lituania,34,40,0,74
2016,Septiembre,Líbano,20,35,0,55
2016,Septiembre,Libia,0,1,0,1
2016,Septiembre,Liechtenstein,2,2,0,4
2016,Septiembre,Luxemburgo,7,9,0,16
2016,Septiembre,Macedonia,1,3,0,4
2016,Septiembre,Madagascar,0,1,0,1
2016,Septiembre,Malasia,18,50,0,68
2016,Septiembre,Malí,0,1,0,1
2016,Septiembre,Malta,7,12,0,19
2016,Septiembre,Marruecos,9,48,0,57
2016,Septiembre,Mauricio,1,4,0,5
2016,Septiembre,México,5734,9948,0,15682
2016,Septiembre,República de Moldavia,2,0,0,2
2016,Septiembre,Montenegro,0,2,0,2
2016,Septiembre,Mozambique,3,21,0,24
2016,Septiembre,Myanmar,1,1,0,2
2016,Septiembre,Namibia,0,1,0,1
2016,Septiembre,Nepal,0,1,0,1
2016,Septiembre,Nicaragua,143,178,0,321
2016,Septiembre,Nigeria,2,11,0,13
2016,Septiembre,Noruega,103,178,0,281
2016,Septiembre,Nueva Zelanda,95,141,0,236
2016,Septiembre,Omán,0,1,0,1
2016,Septiembre,Pakistán,2,13,0,15
2016,Septiembre,Panamá,4692,4373,0,9065
2016,Septiembre,Paraguay,417,503,0,920
2016,Septiembre,Perú,5207,6500,0,11707
2016,Septiembre,Palestina,8,4,0,12
2016,Septiembre,Polonia,119,186,0,305
2016,Septiembre,Portugal,223,547,0,770
2016,Septiembre,Qatar,0,1,0,1
2016,Octubre,Argentina,4817,6273,0,11090
2016,Septiembre,Reino Unido de Gran Bretaña e Irlanda del Norte,1040,2166,0,3206
2016,Septiembre,Federación de Rusia,207,241,0,448
2016,Septiembre,República Dominicana,769,1041,0,1810
2016,Septiembre,República Democrática Popular de Corea,2,0,0,2
2016,Septiembre,Rumania,66,75,0,141
2016,Septiembre,Rwanda,0,14,0,14
2016,Septiembre,San Cristóbal y Nevis,6,4,0,10
2016,Septiembre,Samoa Estadounidense/Territorio no incorporado de Estados Unidos,0,1,0,1
2016,Septiembre,San Marino,0,1,0,1
2016,Septiembre,San  Vicente y las Granadinas,2,9,0,11
2016,Septiembre,Santa Lucia,3,5,0,8
2016,Septiembre,Santa Sede/Ciudad del Vaticano,0,3,0,3
2016,Septiembre,Senegal,1,6,0,7
2016,Septiembre,Serbia,10,7,0,17
2016,Septiembre,Singapur,13,27,0,40
2016,Septiembre,República Árabe Siria,0,6,0,6
2016,Septiembre,Sri Lanka,1,4,0,5
2016,Septiembre,Sudáfrica,51,101,0,152
2016,Septiembre,Sudán,0,3,0,3
2016,Septiembre,Suecia,161,267,0,428
2016,Septiembre,Suiza,374,700,0,1074
2016,Septiembre,Surinam,35,26,0,61
2016,Septiembre,Taiwán,67,118,0,185
2016,Septiembre,Tailandia,29,56,0,85
2016,Septiembre,Tanzania,2,1,0,3
2016,Septiembre,Togo,0,1,0,1
2016,Septiembre,Trinidad y Tobago,25,59,0,84
2016,Septiembre,Túnez,3,2,0,5
2016,Septiembre,Turquía,214,391,0,605
2016,Septiembre,Ucrania,23,58,0,81
2016,Septiembre,Uruguay,465,639,0,1104
2016,Septiembre,Uzbekistán,0,27,0,27
2016,Septiembre,Venezuela,25081,29255,0,54336
2016,Septiembre,Vietnam,9,31,0,40
2016,Septiembre,Islas Vírgenes Británicas/Territorio Británico de Ultramar,1,1,0,2
2016,Septiembre,República Árabe de Yemen,0,2,0,2
2016,Septiembre,Zambia,0,1,0,1
2016,Septiembre,Zimbabue,0,4,0,4
2016,Septiembre,Anguila/Territorio Británico de Ultramar,1,1,0,2
2016,Septiembre,Desconocido,74,159,0,233
2016,Octubre,Albania,4,10,0,14
2016,Octubre,Alemania,1864,3058,0,4922
2016,Octubre,Andorra,5,15,0,20
2016,Octubre,Angola,3,4,0,7
2016,Octubre,Antigua y Barbuda,2,11,0,13
2016,Octubre,Países Bajos,1588,2340,0,3928
2016,Octubre,Arabia Saudita,1,9,0,10
2016,Octubre,Argelia,4,6,0,10
2016,Octubre,República de Armenia,3,4,0,7
2016,Octubre,Australia,494,813,0,1307
2016,Octubre,Austria,180,291,0,471
2016,Octubre,Azerbaiyán,3,3,0,6
2016,Octubre,Bahamas,5,9,0,14
2016,Octubre,Bangladesh,0,2,0,2
2016,Octubre,Barbados,17,18,0,35
2016,Octubre,República de Belarús,6,9,0,15
2016,Octubre,Bélgica,247,513,0,760
2016,Octubre,Belice,7,21,0,28
2016,Octubre,Benín,3,2,0,5
2016,Octubre,Bermudas/Territorio Británico de Ultramar,1,5,0,6
2016,Octubre,Bolivia,845,846,0,1691
2016,Octubre,Bosnia y Herzegovina,1,3,0,4
2016,Octubre,Botsuana,1,3,0,4
2016,Octubre,Brasil,8386,8601,0,16987
2016,Octubre,Bulgaria,25,51,0,76
2016,Octubre,Burkina Faso,0,1,0,1
2016,Octubre,Burundi,1,2,0,3
2016,Octubre,Cabo Verde,1,1,0,2
2016,Octubre,Islas Caimán/Territorio Británico de Ultramar,3,2,0,5
2016,Octubre,Antártida,1,0,0,1
2016,Octubre,Camerún,4,2,0,6
2016,Octubre,Canadá,999,1909,0,2908
2016,Octubre,España,3367,7135,0,10502
2016,Octubre,República Del Congo,0,6,0,6
2016,Octubre,Comoras,1,2,0,3
2016,Octubre,República Democrática del Congo,3,2,0,5
2016,Octubre,República de Corea,227,500,0,727
2016,Octubre,Costa de Marfil,2,1,0,3
2016,Octubre,Costa Rica,1403,1822,0,3225
2016,Octubre,Croacia,23,51,0,74
2016,Octubre,Cuba,253,479,0,732
2016,Octubre,República Checa,70,101,0,171
2016,Octubre,Chile,5958,6522,0,12480
2016,Octubre,China,454,1015,0,1469
2016,Octubre,Chipre,3,12,0,15
2016,Octubre,Dinamarca,131,198,0,329
2016,Octubre,Dominica,5,6,0,11
2016,Octubre,Ecuador,6245,8458,0,14703
2016,Octubre,Egipto,7,25,0,32
2016,Octubre,El Salvador,1074,1364,0,2438
2016,Octubre,Emiratos Árabes,0,11,0,11
2016,Octubre,Eritrea,0,1,0,1
2016,Octubre,Eslovaquia,47,54,0,101
2016,Octubre,Eslovenia,19,30,0,49
2016,Octubre,Estados Unidos de América,10621,20709,0,31330
2016,Octubre,Estonia,20,34,0,54
2016,Octubre,Etiopia,1,3,0,4
2016,Octubre,Islas Fiji,0,1,0,1
2016,Octubre,Filipinas,58,261,0,319
2016,Octubre,Finlandia,60,94,0,154
2016,Octubre,Francia,1714,2939,0,4653
2016,Octubre,Gabón,2,2,0,4
2016,Octubre,Georgia,6,11,0,17
2016,Octubre,Ghana,2,9,0,11
2016,Octubre,Granada,2,5,0,7
2016,Octubre,Grecia,42,92,0,134
2016,Octubre,Guatemala,877,1380,0,2257
2016,Octubre,Guyana,15,16,0,31
2016,Octubre,Guinea Ecuatorial,1,3,0,4
2016,Octubre,Haití,7,26,0,33
2016,Octubre,Honduras,674,823,0,1497
2016,Octubre,Hong Kong,5,4,0,9
2016,Octubre,Hungría,47,58,0,105
2016,Octubre,India,72,485,0,557
2016,Octubre,Indonesia,26,45,0,71
2016,Octubre,Iraq,0,3,0,3
2016,Octubre,Irán,7,19,0,26
2016,Octubre,República de Irlanda,135,250,0,385
2016,Octubre,Islandia,6,6,0,12
2016,Octubre,Israel,146,519,0,665
2016,Octubre,Italia,799,2269,0,3068
2016,Octubre,Jamaica,64,78,0,142
2016,Octubre,Islas Salomón,1,0,0,1
2016,Octubre,Japón,153,565,0,718
2016,Octubre,Jordania,3,5,0,8
2016,Octubre,Kazajistán,2,4,0,6
2016,Octubre,Kenia,9,11,0,20
2016,Octubre,Kiribati,0,1,0,1
2016,Octubre,Kirguistán,0,2,0,2
2016,Octubre,Kuwait,0,2,0,2
2016,Octubre,República de Kosovo,1,2,0,3
2016,Octubre,Letonia,5,11,0,16
2016,Octubre,Lituania,33,38,0,71
2016,Octubre,Líbano,16,42,0,58
2016,Octubre,Liberia,1,0,0,1
2016,Octubre,Liechtenstein,0,1,0,1
2016,Octubre,Luxemburgo,3,10,0,13
2016,Octubre,Macedonia,1,1,0,2
2016,Octubre,Madagascar,0,1,0,1
2016,Octubre,Malasia,15,32,0,47
2016,Octubre,Malawi,0,2,0,2
2016,Octubre,Maldivas,1,0,0,1
2016,Octubre,Malí,0,1,0,1
2016,Octubre,Malta,2,9,0,11
2016,Octubre,Marruecos,14,42,0,56
2016,Octubre,Mauricio,2,6,0,8
2016,Octubre,Mauritania,2,0,0,2
2016,Octubre,México,4978,8851,0,13829
2016,Octubre,República de Moldavia,1,0,0,1
2016,Octubre,Mongolia,0,2,0,2
2016,Octubre,Montenegro,0,2,0,2
2016,Octubre,Mozambique,2,5,0,7
2016,Octubre,Myanmar,0,1,0,1
2016,Octubre,Namibia,1,1,0,2
2016,Octubre,Nepal,2,6,0,8
2016,Octubre,Nicaragua,129,157,0,286
2016,Octubre,Nigeria,4,11,0,15
2016,Octubre,Noruega,122,173,0,295
2016,Octubre,Nueva Zelanda,82,161,0,243
2016,Octubre,Papúa Nueva Guinea,5,2,0,7
2016,Octubre,Pakistán,3,24,0,27
2016,Octubre,Panamá,3540,3759,0,7299
2016,Octubre,Paraguay,388,425,0,813
2016,Octubre,Perú,6381,7669,0,14050
2016,Octubre,Palestina,2,1,0,3
2016,Octubre,Polonia,244,286,0,530
2016,Octubre,Portugal,257,658,0,915
2016,Octubre,Puerto Rico/Territorio de Estados Unidos,1,0,0,1
2016,Octubre,Qatar,0,1,0,1
2016,Octubre,Reino Unido de Gran Bretaña e Irlanda del Norte,1084,2196,0,3280
2016,Octubre,República CentroÁfricana,0,2,0,2
2016,Octubre,Federación de Rusia,240,351,0,591
2016,Octubre,República Dominicana,753,1103,0,1856
2016,Octubre,Rumania,73,120,0,193
2016,Octubre,Rwanda,1,1,0,2
2016,Octubre,San Cristóbal y Nevis,1,2,0,3
2016,Octubre,San  Vicente y las Granadinas,3,4,0,7
2016,Octubre,Santa Lucia,6,6,0,12
2016,Octubre,Santa Sede/Ciudad del Vaticano,0,2,0,2
2016,Octubre,Senegal,5,4,0,9
2016,Octubre,Serbia,7,17,0,24
2016,Octubre,Sierra Leona,1,3,0,4
2016,Octubre,Singapur,21,40,0,61
2016,Octubre,República Árabe Siria,2,0,0,2
2016,Octubre,Somalia,0,2,0,2
2016,Octubre,Sri Lanka,2,9,0,11
2016,Octubre,Sudáfrica,69,149,0,218
2016,Octubre,Sudán,0,1,0,1
2016,Octubre,Suecia,209,339,0,548
2016,Octubre,Suiza,470,783,0,1253
2016,Octubre,Surinam,26,36,0,62
2016,Octubre,Suazilandia,0,2,0,2
2016,Octubre,Taiwán,95,122,0,217
2016,Octubre,República de Tayikistán,1,1,0,2
2016,Octubre,Tailandia,15,14,0,29
2016,Octubre,Tanzania,1,0,0,1
2016,Octubre,Togo,0,1,0,1
2016,Octubre,Trinidad y Tobago,36,68,0,104
2016,Octubre,Túnez,3,13,0,16
2016,Octubre,Turquía,206,456,0,662
2016,Octubre,Ucrania,36,46,0,82
2016,Octubre,Uganda,3,2,0,5
2016,Octubre,Uruguay,505,844,0,1349
2016,Octubre,Uzbekistán,0,1,0,1
2016,Octubre,Venezuela,19400,23501,0,42901
2016,Octubre,Vietnam,1,30,0,31
2016,Octubre,República Árabe de Yemen,0,1,0,1
2016,Octubre,Zambia,1,3,0,4
2016,Octubre,Zimbabue,0,6,0,6
2016,Octubre,Desconocido,109,204,0,313
2016,Noviembre,Afganistán,0,1,0,1
2016,Noviembre,Albania,2,4,0,6
2016,Noviembre,Alemania,1816,3051,0,4867
2016,Noviembre,Andorra,2,16,0,18
2016,Noviembre,Angola,1,2,0,3
2016,Noviembre,Antigua y Barbuda,2,14,0,16
2016,Noviembre,Países Bajos,1570,2321,0,3891
2016,Noviembre,Arabia Saudita,0,3,0,3
2016,Noviembre,Argelia,4,5,0,9
2016,Noviembre,Argentina,5030,6677,0,11707
2016,Noviembre,República de Armenia,1,2,0,3
2016,Noviembre,Aruba,2,1,0,3
2016,Noviembre,Australia,529,876,0,1405
2016,Noviembre,Austria,180,349,0,529
2016,Noviembre,Azerbaiyán,6,5,0,11
2016,Noviembre,Bahamas,7,14,0,21
2016,Noviembre,Bahréin,0,2,0,2
2016,Noviembre,Bangladesh,1,5,0,6
2016,Noviembre,Barbados,10,15,0,25
2016,Noviembre,República de Belarús,4,3,0,7
2016,Noviembre,Bélgica,296,567,0,863
2016,Noviembre,Belice,5,25,0,30
2016,Noviembre,Benín,1,4,0,5
2016,Noviembre,Bermudas/Territorio Británico de Ultramar,0,3,0,3
2016,Noviembre,Bolivia,777,922,0,1699
2016,Noviembre,Bosnia y Herzegovina,0,1,0,1
2016,Noviembre,Botsuana,1,0,0,1
2016,Noviembre,Brasil,7207,8354,0,15561
2016,Noviembre,Bulgaria,28,47,0,75
2016,Noviembre,Burkina Faso,0,2,0,2
2016,Noviembre,Burundi,0,1,0,1
2016,Noviembre,Bután,0,2,0,2
2016,Noviembre,Cabo Verde,0,1,0,1
2016,Noviembre,Islas Caimán/Territorio Británico de Ultramar,2,4,0,6
2016,Noviembre,Camerún,3,3,0,6
2016,Noviembre,Canadá,1235,2385,0,3620
2016,Noviembre,Chad,0,3,0,3
2016,Noviembre,España,3722,8091,0,11813
2016,Noviembre,República Del Congo,0,2,0,2
2016,Noviembre,República Democrática del Congo,1,8,0,9
2016,Noviembre,República de Corea,254,525,0,779
2016,Noviembre,Costa de Marfil,1,2,0,3
2016,Noviembre,Costa Rica,1459,1883,0,3342
2016,Noviembre,Croacia,11,68,0,79
2016,Noviembre,Cuba,241,435,0,676
2016,Noviembre,República Checa,62,144,0,206
2016,Noviembre,Chile,4963,6915,0,11878
2016,Noviembre,China,452,1188,0,1640
2016,Noviembre,Chipre,1,5,0,6
2016,Noviembre,Dinamarca,129,226,0,355
2016,Noviembre,Dominica,2,2,0,4
2016,Noviembre,Ecuador,6765,8682,0,15447
2016,Noviembre,Egipto,3,27,0,30
2016,Noviembre,El Salvador,1367,1479,0,2846
2016,Noviembre,Emiratos Árabes,1,16,0,17
2016,Noviembre,Eritrea,0,1,0,1
2016,Noviembre,Eslovaquia,35,54,0,89
2016,Noviembre,Eslovenia,16,43,0,59
2016,Noviembre,Estados Unidos de América,12780,23358,0,36138
2016,Noviembre,Estonia,25,26,0,51
2016,Noviembre,Etiopia,2,6,0,8
2016,Noviembre,Islas Fiji,1,1,0,2
2016,Noviembre,Filipinas,43,270,0,313
2016,Noviembre,Finlandia,70,105,0,175
2016,Noviembre,Francia,1636,2941,0,4577
2016,Noviembre,Georgia,4,12,0,16
2016,Noviembre,Ghana,5,11,0,16
2016,Noviembre,Granada,4,6,0,10
2016,Noviembre,Grecia,28,103,0,131
2016,Noviembre,Guatemala,1019,1432,0,2451
2016,Noviembre,Guyana,12,16,0,28
2016,Noviembre,Guinea,0,1,0,1
2016,Noviembre,Haití,20,24,0,44
2016,Noviembre,Honduras,459,552,0,1011
2016,Noviembre,Hong Kong,3,9,0,12
2016,Noviembre,Hungría,50,71,0,121
2016,Noviembre,India,96,618,0,714
2016,Noviembre,Indonesia,32,68,0,100
2016,Noviembre,Iraq,0,2,0,2
2016,Noviembre,Irán,1,19,0,20
2016,Noviembre,República de Irlanda,165,298,0,463
2016,Noviembre,Islandia,6,14,0,20
2016,Noviembre,Israel,95,548,0,643
2016,Noviembre,Italia,976,2779,0,3755
2016,Noviembre,Jamaica,20,44,0,64
2016,Noviembre,Japón,159,603,0,762
2016,Noviembre,Jordania,5,8,0,13
2016,Noviembre,Kazajistán,6,3,0,9
2016,Noviembre,Kenia,11,18,0,29
2016,Noviembre,Kirguistán,1,1,0,2
2016,Noviembre,Kuwait,0,2,0,2
2016,Noviembre,República de Kosovo,0,1,0,1
2016,Noviembre,Lesoto,1,1,0,2
2016,Noviembre,Letonia,29,36,0,65
2016,Noviembre,Lituania,35,34,0,69
2016,Noviembre,Líbano,13,30,0,43
2016,Noviembre,Liechtenstein,2,3,0,5
2016,Noviembre,Luxemburgo,5,10,0,15
2016,Noviembre,Macedonia,1,3,0,4
2016,Noviembre,Madagascar,3,0,0,3
2016,Noviembre,Malasia,37,41,0,78
2016,Noviembre,Malawi,1,2,0,3
2016,Noviembre,Malí,0,6,0,6
2016,Noviembre,Malta,2,7,0,9
2016,Noviembre,Marruecos,6,13,0,19
2016,Noviembre,Mauricio,1,7,0,8
2016,Noviembre,México,4805,8996,0,13801
2016,Noviembre,República de Moldavia,3,1,0,4
2016,Noviembre,Mónaco,0,2,0,2
2016,Noviembre,Mongolia,1,1,0,2
2016,Noviembre,Montenegro,1,5,0,6
2016,Noviembre,Mozambique,1,5,0,6
2016,Noviembre,Myanmar,1,15,0,16
2016,Noviembre,Nepal,2,12,0,14
2016,Noviembre,Nicaragua,195,126,0,321
2016,Noviembre,Nigeria,7,23,0,30
2016,Noviembre,Noruega,131,221,0,352
2016,Noviembre,Nueva Zelanda,84,142,0,226
2016,Noviembre,Omán,0,2,0,2
2016,Noviembre,Papúa Nueva Guinea,0,1,0,1
2016,Noviembre,Pakistán,3,13,0,16
2016,Noviembre,Panamá,5522,4955,0,10477
2016,Noviembre,Paraguay,311,367,0,678
2016,Noviembre,Perú,5549,6864,0,12413
2016,Noviembre,Palestina,0,1,0,1
2016,Noviembre,Polonia,224,321,0,545
2016,Noviembre,Portugal,243,568,0,811
2016,Noviembre,Puerto Rico/Territorio de Estados Unidos,0,1,0,1
2016,Noviembre,Qatar,0,2,0,2
2016,Noviembre,Reino Unido de Gran Bretaña e Irlanda del Norte,1166,2613,0,3779
2016,Noviembre,Federación de Rusia,205,308,0,513
2016,Noviembre,República Dominicana,807,1036,0,1843
2016,Noviembre,Rumania,68,95,0,163
2016,Noviembre,Rwanda,0,1,0,1
2016,Noviembre,San Cristóbal y Nevis,2,1,0,3
2016,Noviembre,San Marino,1,1,0,2
2016,Noviembre,San  Vicente y las Granadinas,2,1,0,3
2016,Noviembre,Santa Lucia,2,7,0,9
2016,Diciembre,Barbados,20,15,0,35
2016,Noviembre,Santa Sede/Ciudad del Vaticano,0,2,0,2
2016,Noviembre,Senegal,2,5,0,7
2016,Noviembre,Serbia,9,21,0,30
2016,Noviembre,Seychelles,0,1,0,1
2016,Noviembre,Sierra Leona,0,2,0,2
2016,Noviembre,Singapur,25,47,0,72
2016,Noviembre,República Árabe Siria,0,1,0,1
2016,Noviembre,Sri Lanka,3,9,0,12
2016,Noviembre,Sudáfrica,44,92,0,136
2016,Noviembre,Sudán,0,2,0,2
2016,Noviembre,Suecia,231,345,0,576
2016,Noviembre,Suiza,503,824,0,1327
2016,Noviembre,Surinam,23,27,0,50
2016,Noviembre,Suazilandia,0,1,0,1
2016,Noviembre,Taiwán,66,101,0,167
2016,Noviembre,Tailandia,31,16,0,47
2016,Noviembre,Tanzania,1,16,0,17
2016,Noviembre,Tonga,1,0,0,1
2016,Noviembre,Trinidad y Tobago,32,73,0,105
2016,Noviembre,Túnez,1,11,0,12
2016,Noviembre,Turquía,194,391,0,585
2016,Noviembre,Ucrania,27,47,0,74
2016,Noviembre,Uganda,4,2,0,6
2016,Noviembre,Uruguay,438,606,0,1044
2016,Noviembre,Venezuela,18533,22501,0,41034
2016,Noviembre,Vietnam,10,14,0,24
2016,Noviembre,República Árabe de Yemen,0,1,0,1
2016,Noviembre,Zambia,1,6,0,7
2016,Noviembre,Zimbabue,9,9,0,18
2016,Noviembre,Anguila/Territorio Británico de Ultramar,0,1,0,1
2016,Noviembre,Islas Turcas y Caicos/Territorio Británico de Ultramar,1,0,0,1
2016,Noviembre,Refugiado,0,2,0,2
2016,Noviembre,Desconocido,0,1,0,1
2016,Noviembre,Desconocido,90,174,0,264
2016,Diciembre,Albania,1,4,0,5
2016,Diciembre,Alemania,2310,3623,0,5933
2016,Diciembre,Andorra,3,7,0,10
2016,Diciembre,Angola,0,7,0,7
2016,Diciembre,Antigua y Barbuda,3,13,0,16
2016,Diciembre,Países Bajos,1882,2975,0,4857
2016,Diciembre,Arabia Saudita,0,23,0,23
2016,Diciembre,Argelia,2,10,0,12
2016,Diciembre,Argentina,5742,7292,0,13034
2016,Diciembre,República de Armenia,2,1,0,3
2016,Diciembre,Australia,712,1193,0,1905
2016,Diciembre,Austria,219,353,0,572
2016,Diciembre,Azerbaiyán,3,1,0,4
2016,Diciembre,Bahamas,11,11,0,22
2016,Diciembre,Bahréin,0,3,0,3
2016,Diciembre,Bangladesh,0,4,0,4
2016,Diciembre,República de Belarús,9,8,0,17
2016,Diciembre,Bélgica,330,637,0,967
2016,Diciembre,Belice,4,18,0,22
2016,Diciembre,Bermudas/Territorio Británico de Ultramar,3,3,0,6
2016,Diciembre,Bolivia,1193,1155,0,2348
2016,Diciembre,Bosnia y Herzegovina,7,5,0,12
2016,Diciembre,Botsuana,2,1,0,3
2016,Diciembre,Brasil,7378,7694,0,15072
2016,Diciembre,Brunei Darussalam,0,1,0,1
2016,Diciembre,Bulgaria,33,45,0,78
2016,Diciembre,Burkina Faso,0,1,0,1
2016,Diciembre,Islas Caimán/Territorio Británico de Ultramar,6,29,0,35
2016,Diciembre,Camerún,1,4,0,5
2016,Diciembre,Canadá,2526,3687,0,6213
2016,Diciembre,España,4226,7415,0,11641
2016,Diciembre,República Del Congo,0,1,0,1
2016,Diciembre,República Democrática del Congo,1,5,0,6
2016,Diciembre,República de Corea,323,474,0,797
2016,Diciembre,Costa de Marfil,0,2,0,2
2016,Diciembre,Costa Rica,1892,2040,0,3932
2016,Diciembre,Croacia,21,58,0,79
2016,Diciembre,Cuba,271,623,0,894
2016,Diciembre,República Checa,69,94,0,163
2016,Diciembre,Chile,4129,5366,0,9495
2016,Diciembre,China,384,747,0,1131
2016,Diciembre,Chipre,3,5,0,8
2016,Diciembre,Dinamarca,183,287,0,470
2016,Diciembre,Dominica,2,4,0,6
2016,Diciembre,Ecuador,6744,8649,0,15393
2016,Diciembre,Egipto,11,49,0,60
2016,Diciembre,El Salvador,964,1123,0,2087
2016,Diciembre,Emiratos Árabes,0,15,0,15
2016,Diciembre,Eritrea,0,1,0,1
2016,Diciembre,Eslovaquia,35,44,0,79
2016,Diciembre,Eslovenia,22,36,0,58
2016,Diciembre,Estados Unidos de América,20083,32157,0,52240
2016,Diciembre,Estonia,17,22,0,39
2016,Diciembre,Etiopia,1,9,0,10
2016,Diciembre,Filipinas,43,291,0,334
2016,Diciembre,Finlandia,118,167,0,285
2016,Diciembre,Francia,2525,3961,0,6486
2016,Diciembre,Georgia,4,13,0,17
2016,Diciembre,Ghana,2,13,0,15
2016,Diciembre,Granada,3,5,0,8
2016,Diciembre,Grecia,56,139,0,195
2016,Diciembre,Guatemala,1024,1311,0,2335
2016,Diciembre,Guyana,15,17,0,32
2016,Diciembre,Guinea Ecuatorial,1,1,0,2
2016,Diciembre,Haití,13,20,0,33
2016,Diciembre,Honduras,411,447,0,858
2016,Diciembre,Hong Kong,5,14,0,19
2016,Diciembre,Hungría,48,57,0,105
2016,Diciembre,India,102,489,0,591
2016,Diciembre,Indonesia,14,30,0,44
2016,Diciembre,Irán,16,13,0,29
2016,Diciembre,República de Irlanda,156,284,0,440
2016,Diciembre,Islandia,2,13,0,15
2016,Diciembre,Israel,153,529,0,682
2016,Diciembre,Italia,1317,2752,0,4069
2016,Diciembre,Jamaica,24,59,0,83
2016,Diciembre,Japón,267,489,0,756
2016,Diciembre,Jordania,0,13,0,13
2016,Diciembre,Kazajistán,5,2,0,7
2016,Diciembre,Kenia,3,1,0,4
2016,Diciembre,Kiribati,0,1,0,1
2016,Diciembre,Kirguistán,1,0,0,1
2016,Diciembre,Kuwait,3,3,0,6
2016,Diciembre,República de Kosovo,0,1,0,1
2016,Diciembre,Letonia,14,15,0,29
2016,Diciembre,Lituania,28,30,0,58
2016,Diciembre,Líbano,18,37,0,55
2016,Diciembre,Libia,0,1,0,1
2016,Diciembre,Liechtenstein,0,4,0,4
2016,Diciembre,Luxemburgo,6,13,0,19
2016,Diciembre,Madagascar,1,0,0,1
2016,Diciembre,Malasia,22,31,0,53
2016,Diciembre,Malta,4,12,0,16
2016,Diciembre,Marruecos,12,27,0,39
2016,Diciembre,Mauricio,2,3,0,5
2016,Diciembre,México,5333,8139,0,13472
2016,Diciembre,República de Moldavia,3,1,0,4
2016,Diciembre,Mongolia,1,1,0,2
2016,Diciembre,Montenegro,1,4,0,5
2016,Diciembre,Mozambique,2,2,0,4
2016,Diciembre,Myanmar,0,1,0,1
2016,Diciembre,Namibia,4,0,0,4
2016,Diciembre,Nepal,2,4,0,6
2016,Diciembre,Nicaragua,127,105,0,232
2016,Diciembre,Nigeria,3,9,0,12
2016,Diciembre,Noruega,192,297,0,489
2016,Diciembre,Nueva Zelanda,138,188,0,326
2016,Diciembre,Omán,0,1,0,1
2016,Diciembre,Pakistán,3,12,0,15
2016,Diciembre,Panamá,3677,4308,0,7985
2016,Diciembre,Paraguay,318,297,0,615
2016,Diciembre,Perú,4348,5708,0,10056
2016,Diciembre,Palestina,1,7,0,8
2016,Diciembre,Polonia,165,228,0,393
2016,Diciembre,Portugal,231,471,0,702
2016,Diciembre,Qatar,0,1,0,1
2016,Diciembre,Reino Unido de Gran Bretaña e Irlanda del Norte,1557,3085,0,4642
2016,Diciembre,Federación de Rusia,235,288,0,523
2016,Diciembre,República Dominicana,620,808,0,1428
2016,Diciembre,Rumania,78,108,0,186
2016,Diciembre,San Cristóbal y Nevis,0,4,0,4
2016,Diciembre,San Marino,2,3,0,5
2016,Diciembre,San  Vicente y las Granadinas,2,6,0,8
2016,Diciembre,Santa Lucia,4,5,0,9
2016,Diciembre,Serbia,15,19,0,34
2016,Diciembre,Sierra Leona,0,1,0,1
2016,Diciembre,Singapur,28,38,0,66
2016,Diciembre,República Árabe Siria,3,9,0,12
2016,Diciembre,Somalia,1,0,0,1
2016,Diciembre,Sri Lanka,3,6,0,9
2016,Diciembre,Sudáfrica,58,101,0,159
2016,Diciembre,Sudán,0,1,0,1
2016,Diciembre,Suecia,489,699,0,1188
2016,Diciembre,Suiza,837,1446,0,2283
2016,Diciembre,Surinam,93,122,0,215
2016,Diciembre,Taiwán,64,77,0,141
2016,Diciembre,Tailandia,21,11,0,32
2016,Diciembre,Tanzania,1,0,0,1
2016,Diciembre,Togo,0,1,0,1
2016,Diciembre,Trinidad y Tobago,32,100,0,132
2016,Diciembre,Túnez,0,6,0,6
2016,Diciembre,Turquía,182,342,0,524
2016,Diciembre,Ucrania,36,36,0,72
2016,Diciembre,Uganda,0,1,0,1
2016,Diciembre,Uruguay,423,592,0,1015
2016,Diciembre,Uzbekistán,1,4,0,5
2016,Diciembre,Venezuela,21021,21783,0,42804
2016,Diciembre,Vietnam,2,6,0,8
2016,Diciembre,Islas Vírgenes Británicas/Territorio Británico de Ultramar,2,1,0,3
2016,Diciembre,República Árabe de Yemen,0,4,0,4
2016,Diciembre,Zambia,0,1,0,1
2016,Diciembre,Zimbabue,2,1,0,3
2016,Diciembre,Refugiado,1,6,0,7
2016,Diciembre,Desconocido,65,93,0,158
2017,Enero,Afganistán,0,3,0,3
2017,Enero,Albania,5,8,0,13
2017,Enero,Alemania,2253,3366,0,5619
2017,Enero,Andorra,1,8,0,9
2017,Enero,Angola,1,1,0,2
2017,Enero,Antigua y Barbuda,2,14,0,16
2017,Enero,Países Bajos,1679,2362,0,4041
2017,Enero,Arabia Saudita,0,5,0,5
2017,Enero,Argelia,3,5,0,8
2017,Enero,Argentina,10615,10381,0,20996
2017,Enero,República de Armenia,1,1,0,2
2017,Enero,Australia,668,1031,0,1699
2017,Enero,Austria,243,389,0,632
2017,Enero,Azerbaiyán,2,5,0,7
2017,Enero,Bahamas,9,18,0,27
2017,Enero,Bahréin,1,1,0,2
2017,Enero,Bangladesh,1,2,0,3
2017,Enero,Barbados,7,20,0,27
2017,Enero,República de Belarús,11,17,0,28
2017,Enero,Bélgica,361,551,0,912
2017,Enero,Belice,5,10,0,15
2017,Enero,Benín,4,1,0,5
2017,Enero,Bermudas/Territorio Británico de Ultramar,0,3,0,3
2017,Enero,Bolivia,927,970,0,1897
2017,Enero,Bosnia y Herzegovina,0,3,0,3
2017,Enero,Botsuana,0,1,0,1
2017,Enero,Brasil,8382,8507,0,16889
2017,Enero,Brunei Darussalam,1,0,0,1
2017,Enero,Bulgaria,43,39,0,82
2017,Enero,Islas Caimán/Territorio Británico de Ultramar,2,5,0,7
2017,Enero,Camerún,1,4,0,5
2017,Enero,Canadá,2558,3568,0,6126
2017,Enero,España,3469,7142,0,10611
2017,Enero,República Del Congo,0,1,0,1
2017,Enero,República Democrática del Congo,1,8,0,9
2017,Enero,República de Corea,416,595,0,1011
2017,Enero,Costa de Marfil,0,1,0,1
2017,Enero,Costa Rica,1747,1851,0,3598
2017,Enero,Croacia,28,75,0,103
2017,Enero,Cuba,265,601,0,866
2017,Enero,República Checa,63,109,0,172
2017,Enero,Chile,5451,6002,0,11453
2017,Enero,China,394,614,0,1008
2017,Enero,Chipre,5,10,0,15
2017,Enero,Dinamarca,189,328,0,517
2017,Enero,República de Yibuti,2,0,0,2
2017,Enero,Dominica,4,8,0,12
2017,Enero,Ecuador,4356,6411,0,10767
2017,Enero,Egipto,3,17,0,20
2017,Enero,El Salvador,1009,1127,0,2136
2017,Enero,Emiratos Árabes,2,4,0,6
2017,Enero,Eslovaquia,63,76,0,139
2017,Enero,Eslovenia,24,53,0,77
2017,Enero,Estados Unidos de América,12163,21770,0,33933
2017,Enero,Estonia,20,24,0,44
2017,Enero,Etiopia,1,5,0,6
2017,Enero,Filipinas,46,143,0,189
2017,Enero,Finlandia,99,129,0,228
2017,Enero,Francia,2724,4146,0,6870
2017,Enero,Gambia,1,0,0,1
2017,Enero,Georgia,3,6,0,9
2017,Enero,Ghana,4,8,0,12
2017,Enero,Granada,2,4,0,6
2017,Enero,Grecia,33,102,0,135
2017,Enero,Guatemala,523,1000,0,1523
2017,Enero,Guyana,12,16,0,28
2017,Enero,Guinea,0,1,0,1
2017,Enero,Guinea Ecuatorial,2,0,0,2
2017,Enero,Guam/Territorio no incorporado de Estados Unidos,1,0,0,1
2017,Enero,Haití,12,26,0,38
2017,Enero,Honduras,342,403,0,745
2017,Enero,Hong Kong,6,1,0,7
2017,Enero,Hungría,49,72,0,121
2017,Enero,India,91,538,0,629
2017,Enero,Indonesia,25,30,0,55
2017,Enero,Iraq,1,2,0,3
2017,Enero,Irán,9,9,0,18
2017,Enero,República de Irlanda,150,297,0,447
2017,Enero,Islandia,7,8,0,15
2017,Enero,Israel,174,627,0,801
2017,Enero,Italia,1167,2928,0,4095
2017,Enero,Jamaica,22,40,0,62
2017,Enero,Japón,196,506,0,702
2017,Enero,Jordania,2,2,0,4
2017,Enero,Kazajistán,2,10,0,12
2017,Enero,Kenia,7,7,0,14
2017,Enero,Kiribati,0,2,0,2
2017,Enero,Kirguistán,0,1,0,1
2017,Enero,Kuwait,0,2,0,2
2017,Enero,República de Kosovo,0,4,0,4
2017,Enero,Letonia,7,26,0,33
2017,Enero,Lituania,32,36,0,68
2017,Enero,Líbano,23,42,0,65
2017,Enero,Liberia,2,0,0,2
2017,Enero,Libia,0,1,0,1
2017,Enero,Liechtenstein,5,5,0,10
2017,Enero,Luxemburgo,12,15,0,27
2017,Enero,Macedonia,1,5,0,6
2017,Enero,Madagascar,1,0,0,1
2017,Enero,Malasia,14,30,0,44
2017,Enero,Malawi,3,1,0,4
2017,Enero,Malta,6,12,0,18
2017,Enero,Marruecos,7,16,0,23
2017,Enero,Mauricio,3,6,0,9
2017,Enero,México,4505,7568,0,12073
2017,Enero,República de Moldavia,2,3,0,5
2017,Enero,Mónaco,2,2,0,4
2017,Enero,Mongolia,3,0,0,3
2017,Enero,Montenegro,0,2,0,2
2017,Enero,Mozambique,0,1,0,1
2017,Enero,Myanmar,0,6,0,6
2017,Enero,Namibia,0,2,0,2
2017,Enero,Nepal,1,2,0,3
2017,Enero,Nicaragua,126,163,0,289
2017,Enero,Nigeria,6,8,0,14
2017,Enero,Noruega,168,257,0,425
2017,Enero,Nueva Zelanda,81,125,0,206
2017,Enero,Pakistán,7,21,0,28
2017,Enero,Panamá,4078,3832,0,7910
2017,Enero,Paraguay,364,365,0,729
2017,Enero,Perú,4805,5846,0,10651
2017,Enero,Palestina,0,1,0,1
2017,Enero,Polonia,217,300,0,517
2017,Enero,Portugal,311,642,0,953
2017,Enero,Puerto Rico/Territorio de Estados Unidos,0,1,0,1
2017,Enero,Qatar,0,3,0,3
2017,Enero,Reino Unido de Gran Bretaña e Irlanda del Norte,1498,2865,0,4363
2017,Enero,República CentroÁfricana,5,0,0,5
2017,Enero,Federación de Rusia,339,390,0,729
2017,Enero,República Dominicana,571,846,0,1417
2017,Enero,Rumania,77,114,0,191
2017,Enero,Rwanda,0,2,0,2
2017,Enero,San Cristóbal y Nevis,1,7,0,8
2017,Enero,San  Vicente y las Granadinas,0,5,0,5
2017,Enero,Santa Lucia,5,4,0,9
2017,Enero,Santa Sede/Ciudad del Vaticano,0,2,0,2
2017,Enero,Senegal,0,1,0,1
2017,Enero,Serbia,8,31,0,39
2017,Enero,Singapur,25,26,0,51
2017,Enero,República Árabe Siria,1,2,0,3
2017,Enero,Sri Lanka,3,6,0,9
2017,Enero,Sudáfrica,57,78,0,135
2017,Enero,Suecia,478,609,0,1087
2017,Enero,Suiza,750,1153,0,1903
2017,Enero,Surinam,10,25,0,35
2017,Enero,Taiwán,75,98,0,173
2017,Enero,Tailandia,15,7,0,22
2017,Enero,Tanzania,2,2,0,4
2017,Enero,República Democrática de Timor Oriental,0,1,0,1
2017,Enero,Trinidad y Tobago,39,100,0,139
2017,Enero,Túnez,1,7,0,8
2017,Enero,Turquía,213,349,0,562
2017,Enero,Ucrania,39,43,0,82
2017,Enero,Uganda,2,1,0,3
2017,Enero,Uruguay,534,636,0,1170
2017,Enero,Uzbekistán,0,1,0,1
2017,Enero,Venezuela,20895,26229,0,47124
2017,Enero,Vietnam,6,13,0,19
2017,Enero,Islas Vírgenes Británicas/Territorio Británico de Ultramar,2,1,0,3
2017,Enero,República Árabe de Yemen,0,1,0,1
2017,Enero,Zambia,2,1,0,3
2017,Enero,Zimbabue,1,5,0,6
2017,Enero,Islas Turcas y Caicos/Territorio Británico de Ultramar,0,1,0,1
2017,Enero,Refugiado Otro,0,1,0,1
2017,Enero,Refugiado,0,3,0,3
2017,Enero,Desconocido,59,135,0,194
2017,Febrero,Afganistán,0,2,0,2
2017,Febrero,Albania,2,7,0,9
2017,Febrero,Alemania,2763,3640,0,6403
2017,Febrero,Andorra,7,18,0,25
2017,Febrero,Angola,2,5,0,7
2017,Febrero,Antigua y Barbuda,2,10,0,12
2017,Febrero,Países Bajos,1661,2437,0,4098
2017,Febrero,Arabia Saudita,0,4,0,4
2017,Febrero,Argelia,3,3,0,6
2017,Febrero,Argentina,8281,9295,0,17576
2017,Febrero,República de Armenia,3,6,0,9
2017,Febrero,Australia,428,731,0,1159
2017,Febrero,Austria,306,460,0,766
2017,Febrero,Azerbaiyán,0,5,0,5
2017,Febrero,Bahamas,8,31,0,39
2017,Febrero,Bahréin,0,2,0,2
2017,Febrero,Bangladesh,0,4,0,4
2017,Febrero,Barbados,13,18,0,31
2017,Febrero,República de Belarús,5,22,0,27
2017,Febrero,Bélgica,407,616,0,1023
2017,Febrero,Belice,12,13,0,25
2017,Febrero,Benín,0,1,0,1
2017,Febrero,Bermudas/Territorio Británico de Ultramar,0,3,0,3
2017,Febrero,Bolivia,753,802,0,1555
2017,Febrero,Bosnia y Herzegovina,3,1,0,4
2017,Febrero,Botsuana,1,0,0,1
2017,Febrero,Brasil,8200,8481,0,16681
2017,Febrero,Bulgaria,55,45,0,100
2017,Febrero,Burkina Faso,1,1,0,2
2017,Febrero,Burundi,1,5,0,6
2017,Febrero,Cabo Verde,0,2,0,2
2017,Febrero,Islas Caimán/Territorio Británico de Ultramar,1,7,0,8
2017,Febrero,Camboya,0,3,0,3
2017,Febrero,Camerún,3,2,0,5
2017,Febrero,Canadá,2584,3751,0,6335
2017,Febrero,Chad,2,1,0,3
2017,Febrero,España,2803,6291,0,9094
2017,Febrero,República Democrática del Congo,0,4,0,4
2017,Febrero,República de Corea,358,539,0,897
2017,Febrero,Costa de Marfil,1,9,0,10
2017,Febrero,Costa Rica,1318,1681,0,2999
2017,Febrero,Croacia,22,89,0,111
2017,Febrero,Cuba,186,459,0,645
2017,Febrero,República Checa,94,182,0,276
2017,Febrero,Chile,7700,7898,0,15598
2017,Febrero,China,511,961,0,1472
2017,Febrero,Chipre,4,5,0,9
2017,Febrero,Dinamarca,220,345,0,565
2017,Febrero,Dominica,2,5,0,7
2017,Febrero,Ecuador,5185,6723,0,11908
2017,Febrero,Egipto,8,38,0,46
2017,Febrero,El Salvador,939,1150,0,2089
2017,Febrero,Emiratos Árabes,1,4,0,5
2017,Febrero,Eritrea,0,1,0,1
2017,Febrero,Eslovaquia,29,44,0,73
2017,Febrero,Eslovenia,58,90,0,148
2017,Febrero,Estados Unidos de América,14765,25458,0,40223
2017,Febrero,Estonia,62,103,0,165
2017,Febrero,Islas Fiji,0,1,0,1
2017,Febrero,Filipinas,52,319,0,371
2017,Febrero,Finlandia,93,129,0,222
2017,Febrero,Francia,2892,4185,0,7077
2017,Febrero,Georgia,13,13,0,26
2017,Febrero,Ghana,3,10,0,13
2017,Febrero,Granada,3,7,0,10
2017,Febrero,Grecia,39,92,0,131
2017,Febrero,Guatemala,597,1105,0,1702
2017,Febrero,Guyana,7,19,0,26
2017,Febrero,Guinea,0,3,0,3
2017,Febrero,Guinea Ecuatorial,2,2,0,4
2017,Febrero,Haití,9,21,0,30
2017,Febrero,Honduras,278,350,0,628
2017,Febrero,Hong Kong,6,7,0,13
2017,Febrero,Hungría,59,98,0,157
2017,Febrero,India,63,479,0,542
2017,Febrero,Indonesia,19,40,0,59
2017,Febrero,Iraq,1,2,0,3
2017,Febrero,Irán,7,15,0,22
2017,Febrero,República de Irlanda,143,271,0,414
2017,Febrero,Islandia,4,19,0,23
2017,Febrero,Israel,226,724,0,950
2017,Febrero,Italia,1160,2841,0,4001
2017,Febrero,Jamaica,27,54,0,81
2017,Febrero,Japón,230,632,0,862
2017,Febrero,Jordania,2,8,0,10
2017,Febrero,Kazajistán,9,9,0,18
2017,Febrero,Kenia,6,13,0,19
2017,Febrero,Kiribati,0,1,0,1
2017,Febrero,Kuwait,0,4,0,4
2017,Febrero,República de Kosovo,2,0,0,2
2017,Febrero,Letonia,7,25,0,32
2017,Febrero,Lituania,35,49,0,84
2017,Febrero,Líbano,10,29,0,39
2017,Febrero,Libia,2,1,0,3
2017,Febrero,Liechtenstein,2,2,0,4
2017,Febrero,Luxemburgo,13,18,0,31
2017,Febrero,Macedonia,2,0,0,2
2017,Febrero,Madagascar,1,0,0,1
2017,Febrero,Malasia,10,31,0,41
2017,Febrero,Malí,3,2,0,5
2017,Febrero,Malta,10,14,0,24
2017,Febrero,Marruecos,14,20,0,34
2017,Febrero,Mauricio,0,2,0,2
2017,Febrero,Mauritania,0,2,0,2
2017,Febrero,México,4072,8008,0,12080
2017,Febrero,República de Moldavia,4,0,0,4
2017,Febrero,Mónaco,4,3,0,7
2017,Febrero,Mongolia,4,1,0,5
2017,Febrero,Mozambique,2,0,0,2
2017,Febrero,Namibia,1,2,0,3
2017,Febrero,Nepal,1,3,0,4
2017,Febrero,Nicaragua,100,127,0,227
2017,Febrero,Nigeria,2,26,0,28
2017,Febrero,Níger,4,0,0,4
2017,Febrero,Noruega,170,239,0,409
2017,Febrero,Nueva Zelanda,84,139,0,223
2017,Febrero,Pakistán,3,15,0,18
2017,Febrero,Panamá,5669,5047,0,10716
2017,Febrero,Paraguay,274,274,0,548
2017,Febrero,Perú,5863,6716,0,12579
2017,Febrero,Palestina,0,6,0,6
2017,Febrero,Polonia,185,302,0,487
2017,Febrero,Portugal,193,506,0,699
2017,Febrero,Reino Unido de Gran Bretaña e Irlanda del Norte,1504,2663,0,4167
2017,Febrero,República CentroÁfricana,0,1,0,1
2017,Febrero,Federación de Rusia,195,283,0,478
2017,Febrero,República Dominicana,609,830,0,1439
2017,Febrero,Rumania,72,111,0,183
2017,Febrero,Rwanda,1,0,0,1
2017,Febrero,San Cristóbal y Nevis,3,7,0,10
2017,Febrero,Samoa Occidental,1,0,0,1
2017,Febrero,San Marino,0,2,0,2
2017,Febrero,San  Vicente y las Granadinas,1,3,0,4
2017,Febrero,Santa Lucia,4,5,0,9
2017,Febrero,Santa Sede/Ciudad del Vaticano,0,1,0,1
2017,Febrero,Senegal,0,2,0,2
2017,Febrero,Serbia,5,29,0,34
2017,Febrero,Singapur,21,20,0,41
2017,Febrero,República Árabe Siria,2,4,0,6
2017,Febrero,Sri Lanka,1,1,0,2
2017,Febrero,Sudáfrica,45,65,0,110
2017,Febrero,Sudán,0,1,0,1
2017,Febrero,Suecia,359,523,0,882
2017,Febrero,Suiza,720,1094,0,1814
2017,Febrero,Surinam,19,24,0,43
2017,Febrero,Taiwán,97,97,0,194
2017,Febrero,República de Tayikistán,0,1,0,1
2017,Febrero,Tailandia,12,8,0,20
2017,Febrero,Tanzania,0,2,0,2
2017,Febrero,Trinidad y Tobago,48,98,0,146
2017,Febrero,Túnez,10,9,0,19
2017,Febrero,Turquía,189,343,0,532
2017,Febrero,Ucrania,19,47,0,66
2017,Febrero,Uganda,0,2,0,2
2017,Febrero,Uruguay,466,542,0,1008
2017,Febrero,Uzbekistán,2,0,0,2
2017,Febrero,Venezuela,17603,22350,0,39953
2017,Febrero,Vietnam,4,23,0,27
2017,Febrero,Islas Vírgenes Británicas/Territorio Británico de Ultramar,2,0,0,2
2017,Febrero,Zimbabue,1,0,0,1
2017,Febrero,Islas Turcas y Caicos/Territorio Británico de Ultramar,1,0,0,1
2017,Febrero,Refugiado,5,7,0,12
2017,Febrero,Desconocido,79,119,0,198
2017,Marzo,Albania,2,3,0,5
2017,Marzo,Alemania,2717,3920,0,6637
2017,Marzo,Andorra,1,12,0,13
2017,Marzo,Antigua y Barbuda,1,4,0,5
2017,Marzo,Países Bajos,1598,2337,0,3935
2017,Marzo,Arabia Saudita,2,11,0,13
2017,Marzo,Argelia,0,7,0,7
2017,Marzo,Argentina,9626,10495,0,20121
2017,Marzo,República de Armenia,1,5,0,6
2017,Marzo,Australia,403,784,0,1187
2017,Marzo,Austria,186,327,0,513
2017,Marzo,Azerbaiyán,3,7,0,10
2017,Marzo,Bahamas,13,14,0,27
2017,Marzo,Bahréin,0,1,0,1
2017,Marzo,Bangladesh,4,4,0,8
2017,Marzo,Barbados,7,10,0,17
2017,Marzo,República de Belarús,8,8,0,16
2017,Marzo,Bélgica,352,630,0,982
2017,Marzo,Belice,4,13,0,17
2017,Marzo,Benín,2,0,0,2
2017,Marzo,Bermudas/Territorio Británico de Ultramar,0,4,0,4
2017,Marzo,Bolivia,539,706,0,1245
2017,Marzo,Bosnia y Herzegovina,1,1,0,2
2017,Marzo,Botsuana,0,2,0,2
2017,Marzo,Brasil,7597,8435,0,16032
2017,Marzo,Bulgaria,46,41,0,87
2017,Marzo,Burkina Faso,0,1,0,1
2017,Marzo,Burundi,0,1,0,1
2017,Marzo,Bután,1,1,0,2
2017,Marzo,Islas Caimán/Territorio Británico de Ultramar,1,2,0,3
2017,Marzo,Camboya,0,1,0,1
2017,Marzo,Camerún,2,3,0,5
2017,Marzo,Canadá,2454,3530,0,5984
2017,Marzo,Chad,0,2,0,2
2017,Marzo,España,3101,6850,0,9951
2017,Marzo,República Del Congo,0,2,0,2
2017,Marzo,República Democrática del Congo,6,14,0,20
2017,Marzo,República de Corea,264,582,0,846
2017,Marzo,Costa de Marfil,0,3,0,3
2017,Marzo,Costa Rica,1407,1871,0,3278
2017,Marzo,Croacia,26,86,0,112
2017,Marzo,Cuba,205,383,0,588
2017,Marzo,República Checa,106,154,0,260
2017,Marzo,Chile,5115,6257,0,11372
2017,Marzo,China,504,1103,0,1607
2017,Marzo,Chipre,7,6,0,13
2017,Marzo,Dinamarca,173,433,0,606
2017,Marzo,Dominica,0,5,0,5
2017,Marzo,Ecuador,5771,7558,0,13329
2017,Marzo,Egipto,10,36,0,46
2017,Marzo,El Salvador,951,1215,0,2166
2017,Marzo,Emiratos Árabes,5,16,0,21
2017,Marzo,Eritrea,0,1,0,1
2017,Marzo,Eslovaquia,42,59,0,101
2017,Marzo,Eslovenia,23,41,0,64
2017,Marzo,Estados Unidos de América,16447,28013,0,44460
2017,Marzo,Estonia,13,25,0,38
2017,Marzo,Etiopia,2,5,0,7
2017,Marzo,Filipinas,39,254,0,293
2017,Marzo,Finlandia,65,112,0,177
2017,Marzo,Francia,2395,3720,0,6115
2017,Marzo,Georgia,1,4,0,5
2017,Marzo,Ghana,1,11,0,12
2017,Marzo,Granada,0,4,0,4
2017,Marzo,Grecia,36,114,0,150
2017,Marzo,Guatemala,630,1220,0,1850
2017,Marzo,Guyana,15,22,0,37
2017,Marzo,Haití,17,25,0,42
2017,Marzo,Honduras,300,417,0,717
2017,Marzo,Hong Kong,2,5,0,7
2017,Marzo,Hungría,41,59,0,100
2017,Marzo,India,160,682,0,842
2017,Marzo,Indonesia,17,42,0,59
2017,Marzo,Iraq,0,3,0,3
2017,Marzo,Irán,4,16,0,20
2017,Marzo,República de Irlanda,169,276,0,445
2017,Marzo,Islandia,13,24,0,37
2017,Marzo,Israel,489,1146,0,1635
2017,Marzo,Italia,922,2465,0,3387
2017,Marzo,Jamaica,31,24,0,55
2017,Marzo,Islas Salomón,1,0,0,1
2017,Marzo,Japón,234,662,0,896
2017,Marzo,Jordania,5,8,0,13
2017,Marzo,Kazajistán,6,10,0,16
2017,Marzo,Kenia,10,7,0,17
2017,Marzo,Kuwait,4,4,0,8
2017,Marzo,República de Kosovo,1,0,0,1
2017,Marzo,Letonia,22,39,0,61
2017,Marzo,Lituania,34,37,0,71
2017,Marzo,Líbano,25,32,0,57
2017,Marzo,Libia,0,1,0,1
2017,Marzo,Liechtenstein,4,5,0,9
2017,Marzo,Luxemburgo,9,22,0,31
2017,Marzo,Macedonia,2,2,0,4
2017,Marzo,Madagascar,2,0,0,2
2017,Marzo,Malasia,24,35,0,59
2017,Marzo,Malawi,1,2,0,3
2017,Marzo,Malí,4,0,0,4
2017,Marzo,Malta,2,6,0,8
2017,Marzo,Marruecos,4,14,0,18
2017,Marzo,Mauricio,0,4,0,4
2017,Marzo,México,4362,8486,0,12848
2017,Marzo,República de Moldavia,3,1,0,4
2017,Marzo,Mónaco,0,1,0,1
2017,Marzo,Mongolia,2,6,0,8
2017,Marzo,Montenegro,0,2,0,2
2017,Marzo,Mozambique,1,1,0,2
2017,Marzo,Myanmar,0,1,0,1
2017,Marzo,Nepal,0,3,0,3
2017,Marzo,Nicaragua,106,137,0,243
2017,Marzo,Nigeria,10,10,0,20
2017,Marzo,Noruega,176,275,0,451
2017,Marzo,Nueva Zelanda,79,130,0,209
2017,Marzo,Omán,0,4,0,4
2017,Marzo,Pakistán,5,15,0,20
2017,Marzo,Panamá,2573,3039,0,5612
2017,Marzo,Paraguay,294,277,0,571
2017,Marzo,Perú,5303,6437,0,11740
2017,Marzo,Palestina,3,3,0,6
2017,Marzo,Polonia,162,272,0,434
2017,Marzo,Portugal,236,606,0,842
2017,Marzo,Qatar,0,1,0,1
2017,Marzo,Reino Unido de Gran Bretaña e Irlanda del Norte,1474,2916,0,4390
2017,Marzo,Federación de Rusia,195,253,0,448
2017,Marzo,República Dominicana,505,772,0,1277
2017,Marzo,Rumania,61,108,0,169
2017,Marzo,Rwanda,1,0,0,1
2017,Marzo,San Cristóbal y Nevis,0,2,0,2
2017,Marzo,Samoa Occidental,0,1,0,1
2017,Marzo,San  Vicente y las Granadinas,1,2,0,3
2017,Marzo,Santa Lucia,4,4,0,8
2017,Marzo,Santo Tomé y Príncipe,1,1,0,2
2017,Marzo,Senegal,1,2,0,3
2017,Marzo,Serbia,16,21,0,37
2017,Marzo,Sierra Leona,0,2,0,2
2017,Marzo,Singapur,21,52,0,73
2017,Marzo,República Árabe Siria,2,1,0,3
2017,Marzo,Somalia,0,1,0,1
2017,Marzo,Sri Lanka,3,8,0,11
2017,Marzo,Sudáfrica,50,95,0,145
2017,Marzo,Sudán,0,1,0,1
2017,Marzo,Suecia,344,467,0,811
2017,Marzo,Suiza,594,931,0,1525
2017,Marzo,Surinam,17,30,0,47
2017,Marzo,Taiwán,99,151,0,250
2017,Marzo,República de Tayikistán,0,2,0,2
2017,Marzo,Tailandia,16,12,0,28
2017,Marzo,Tanzania,0,2,0,2
2017,Marzo,República Democrática de Timor Oriental,0,2,0,2
2017,Marzo,Togo,0,2,0,2
2017,Marzo,Trinidad y Tobago,24,79,0,103
2017,Marzo,Túnez,1,3,0,4
2017,Marzo,Turquía,189,419,0,608
2017,Marzo,Ucrania,34,44,0,78
2017,Marzo,Uganda,3,5,0,8
2017,Marzo,Uruguay,416,649,0,1065
2017,Marzo,Venezuela,17325,22462,0,39787
2017,Marzo,Vietnam,14,8,0,22
2017,Marzo,República Árabe de Yemen,0,1,0,1
2017,Marzo,Zambia,1,2,0,3
2017,Marzo,Zimbabue,3,5,0,8
2017,Marzo,Islas Turcas y Caicos/Territorio Británico de Ultramar,1,1,0,2
2017,Marzo,Refugiado Otro,0,1,0,1
2017,Marzo,Refugiado,1,1,0,2
2017,Marzo,Desconocido,89,162,0,251
2017,Abril,Afganistán,0,1,0,1
2017,Abril,Albania,2,4,0,6
2017,Abril,Alemania,2204,2946,0,5150
2017,Abril,Andorra,2,8,0,10
2017,Abril,Angola,0,1,0,1
2017,Abril,Antigua y Barbuda,3,4,0,7
2017,Abril,Países Bajos,2046,2702,0,4748
2017,Abril,Arabia Saudita,1,5,0,6
2017,Abril,Argelia,0,3,0,3
2017,Abril,Argentina,7730,8221,0,15951
2017,Abril,República de Armenia,1,3,0,4
2017,Abril,Aruba,0,1,0,1
2017,Abril,Australia,452,712,0,1164
2017,Abril,Austria,156,284,0,440
2017,Abril,Azerbaiyán,1,4,0,5
2017,Abril,Bahamas,9,15,0,24
2017,Abril,Bahréin,1,0,0,1
2017,Abril,Bangladesh,1,5,0,6
2017,Abril,Barbados,14,13,0,27
2017,Abril,República de Belarús,8,5,0,13
2017,Abril,Bélgica,252,515,0,767
2017,Abril,Belice,2,6,0,8
2017,Abril,Bermudas/Territorio Británico de Ultramar,1,1,0,2
2017,Abril,Bolivia,666,801,0,1467
2017,Abril,Bosnia y Herzegovina,1,5,0,6
2017,Abril,Brasil,7554,8113,0,15667
2017,Abril,Bulgaria,28,47,0,75
2017,Abril,Burkina Faso,2,4,0,6
2017,Abril,Burundi,0,1,0,1
2017,Abril,Islas Caimán/Territorio Británico de Ultramar,4,11,0,15
2017,Abril,Camerún,0,3,0,3
2017,Abril,Canadá,1406,2362,0,3768
2017,Abril,España,3603,6714,0,10317
2017,Abril,República Democrática del Congo,2,1,0,3
2017,Abril,República de Corea,229,513,0,742
2017,Abril,Costa de Marfil,3,3,0,6
2017,Abril,Costa Rica,2319,2450,0,4769
2017,Abril,Croacia,18,74,0,92
2017,Abril,Cuba,265,418,0,683
2017,Abril,República Checa,74,93,0,167
2017,Abril,Chile,4699,5682,0,10381
2017,Abril,China,393,930,0,1323
2017,Abril,Chipre,0,9,0,9
2017,Abril,Dinamarca,174,298,0,472
2017,Abril,Dominica,2,5,0,7
2017,Abril,Ecuador,6451,7955,0,14406
2017,Abril,Egipto,2,22,0,24
2017,Abril,El Salvador,1315,1416,0,2731
2017,Abril,Emiratos Árabes,2,12,0,14
2017,Abril,Eritrea,0,1,0,1
2017,Abril,Eslovaquia,37,32,0,69
2017,Abril,Eslovenia,21,56,0,77
2017,Abril,Estados Unidos de América,14715,25123,0,39838
2017,Abril,Estonia,6,7,0,13
2017,Abril,Etiopia,0,9,0,9
2017,Abril,Filipinas,43,362,0,405
2017,Abril,Finlandia,57,88,0,145
2017,Abril,Francia,2311,3373,0,5684
2017,Abril,Georgia,3,13,0,16
2017,Abril,Ghana,3,11,0,14
2017,Abril,Granada,1,4,0,5
2017,Abril,Grecia,56,114,0,170
2017,Abril,Guatemala,803,1273,0,2076
2017,Abril,Guyana,5,12,0,17
2017,Abril,Guinea Bissau,1,2,0,3
2017,Abril,Haití,12,22,0,34
2017,Abril,Honduras,481,560,0,1041
2017,Abril,Hong Kong,5,5,0,10
2017,Abril,Hungría,34,56,0,90
2017,Abril,India,75,522,0,597
2017,Abril,Indonesia,28,65,0,93
2017,Abril,Iraq,0,4,0,4
2017,Abril,Irán,4,5,0,9
2017,Abril,República de Irlanda,158,255,0,413
2017,Abril,Islandia,9,18,0,27
2017,Abril,Israel,805,1536,0,2341
2017,Abril,Italia,954,2193,0,3147
2017,Abril,Jamaica,38,40,0,78
2017,Abril,Japón,213,477,0,690
2017,Abril,Jordania,0,11,0,11
2017,Abril,Kazajistán,6,4,0,10
2017,Abril,Kenia,7,19,0,26
2017,Abril,Kiribati,0,1,0,1
2017,Abril,Kuwait,1,6,0,7
2017,Abril,República de Kosovo,1,1,0,2
2017,Abril,Letonia,12,10,0,22
2017,Abril,Lituania,30,42,0,72
2017,Abril,Líbano,19,29,0,48
2017,Abril,Liberia,1,0,0,1
2017,Abril,Libia,0,2,0,2
2017,Abril,Liechtenstein,5,2,0,7
2017,Abril,Luxemburgo,4,9,0,13
2017,Abril,Macedonia,2,6,0,8
2017,Abril,Madagascar,1,0,0,1
2017,Abril,Malasia,12,30,0,42
2017,Abril,Malawi,0,1,0,1
2017,Abril,Malí,0,1,0,1
2017,Abril,Malta,4,21,0,25
2017,Abril,Marruecos,14,20,0,34
2017,Abril,Mauricio,5,10,0,15
2017,Abril,México,6016,9165,0,15181
2017,Abril,República de Moldavia,3,0,0,3
2017,Abril,Mónaco,3,0,0,3
2017,Abril,Montenegro,0,6,0,6
2017,Abril,Mozambique,2,4,0,6
2017,Abril,Myanmar,0,19,0,19
2017,Abril,Nepal,2,2,0,4
2017,Abril,Nicaragua,117,160,0,277
2017,Abril,Nigeria,0,16,0,16
2017,Abril,Noruega,171,202,0,373
2017,Abril,Nueva Zelanda,72,134,0,206
2017,Abril,Omán,0,2,0,2
2017,Abril,Pakistán,3,18,0,21
2017,Abril,Panamá,4147,3902,0,8049
2017,Abril,Paraguay,318,302,0,620
2017,Abril,Perú,4730,5656,0,10386
2017,Abril,Palestina,1,1,0,2
2017,Abril,Polonia,162,233,0,395
2017,Abril,Portugal,315,587,0,902
2017,Abril,Reino Unido de Gran Bretaña e Irlanda del Norte,1729,2847,0,4576
2017,Abril,Federación de Rusia,236,366,0,602
2017,Abril,República Dominicana,920,977,0,1897
2017,Abril,Rumania,55,94,0,149
2017,Abril,San Cristóbal y Nevis,1,2,0,3
2017,Abril,San Marino,1,0,0,1
2017,Abril,San  Vicente y las Granadinas,0,4,0,4
2017,Abril,Santa Lucia,5,2,0,7
2017,Abril,Senegal,0,3,0,3
2017,Abril,Serbia,11,20,0,31
2017,Abril,Sierra Leona,0,1,0,1
2017,Abril,Singapur,18,29,0,47
2017,Abril,República Árabe Siria,1,10,0,11
2017,Abril,Sri Lanka,1,10,0,11
2017,Abril,Sudáfrica,59,87,0,146
2017,Abril,Sudán,0,2,0,2
2017,Abril,Suecia,260,356,0,616
2017,Abril,Suiza,624,901,0,1525
2017,Abril,Surinam,37,33,0,70
2017,Abril,Taiwán,82,102,0,184
2017,Abril,Tailandia,20,9,0,29
2017,Abril,Tanzania,0,1,0,1
2017,Abril,Togo,0,1,0,1
2017,Abril,Trinidad y Tobago,24,71,0,95
2017,Abril,Túnez,7,6,0,13
2017,Abril,Turquía,135,272,0,407
2017,Abril,Ucrania,24,76,0,100
2017,Abril,Uganda,3,2,0,5
2017,Abril,Uruguay,563,709,0,1272
2017,Abril,Venezuela,20246,23385,0,43631
2017,Abril,Vietnam,4,5,0,9
2017,Abril,República Árabe de Yemen,0,1,0,1
2017,Abril,Zimbabue,1,2,0,3
2017,Abril,Anguila/Territorio Británico de Ultramar,1,0,0,1
2017,Abril,Refugiado,1,2,0,3
2017,Abril,Desconocido,86,161,0,247
2017,Mayo,Afganistán,0,2,0,2
2017,Mayo,Albania,4,1,0,5
2017,Mayo,Alemania,1624,2639,0,4263
2017,Mayo,Andorra,0,10,0,10
2017,Mayo,Angola,0,1,0,1
2017,Mayo,Antigua y Barbuda,0,5,0,5
2017,Mayo,Países Bajos,1505,2158,0,3663
2017,Mayo,Arabia Saudita,0,9,0,9
2017,Mayo,Argelia,3,12,0,15
2017,Mayo,Argentina,7107,8072,0,15179
2017,Mayo,República de Armenia,2,0,0,2
2017,Mayo,Aruba,1,0,0,1
2017,Mayo,Australia,445,773,0,1218
2017,Mayo,Austria,138,232,0,370
2017,Mayo,Azerbaiyán,7,11,0,18
2017,Mayo,Bahamas,8,26,0,34
2017,Mayo,Bahréin,0,1,0,1
2017,Mayo,Bangladesh,4,16,0,20
2017,Mayo,Barbados,19,25,0,44
2017,Mayo,República de Belarús,4,6,0,10
2017,Mayo,Bélgica,231,452,0,683
2017,Mayo,Belice,8,18,0,26
2017,Mayo,Bermudas/Territorio Británico de Ultramar,2,1,0,3
2017,Mayo,Bolivia,1009,978,0,1987
2017,Mayo,Bosnia y Herzegovina,3,4,0,7
2017,Mayo,Brasil,7575,8649,0,16224
2017,Mayo,Bulgaria,38,35,0,73
2017,Mayo,Burkina Faso,0,2,0,2
2017,Mayo,Islas Caimán/Territorio Británico de Ultramar,1,4,0,5
2017,Mayo,Camerún,3,3,0,6
2017,Mayo,Canadá,1310,2174,0,3484
2017,Mayo,España,2745,6388,0,9133
2017,Mayo,República Democrática del Congo,9,13,0,22
2017,Mayo,República de Corea,225,491,0,716
2017,Mayo,Costa de Marfil,0,10,0,10
2017,Mayo,Costa Rica,1618,1959,0,3577
2017,Mayo,Croacia,11,71,0,82
2017,Mayo,Cuba,216,409,0,625
2017,Mayo,República Checa,41,78,0,119
2017,Mayo,Chile,4806,5924,0,10730
2017,Mayo,China,518,1135,0,1653
2017,Mayo,Chipre,3,4,0,7
2017,Mayo,Dinamarca,103,190,0,293
2017,Mayo,Dominica,5,3,0,8
2017,Mayo,Ecuador,5843,8869,0,14712
2017,Mayo,Egipto,2,23,0,25
2017,Mayo,El Salvador,1061,1326,0,2387
2017,Mayo,Emiratos Árabes,8,21,0,29
2017,Mayo,Eslovaquia,23,29,0,52
2017,Mayo,Eslovenia,14,34,0,48
2017,Mayo,Estados Unidos de América,15267,26629,0,41896
2017,Mayo,Estonia,12,22,0,34
2017,Mayo,Etiopia,1,5,0,6
2017,Mayo,Islas Fiji,1,0,0,1
2017,Mayo,Filipinas,53,228,0,281
2017,Mayo,Finlandia,59,80,0,139
2017,Mayo,Francia,1740,2911,0,4651
2017,Mayo,Georgia,7,11,0,18
2017,Mayo,Ghana,8,6,0,14
2017,Mayo,Granada,4,4,0,8
2017,Mayo,Grecia,15,75,0,90
2017,Mayo,Guatemala,762,1266,0,2028
2017,Mayo,Guyana,10,18,0,28
2017,Mayo,Guinea,0,1,0,1
2017,Mayo,Haití,19,30,0,49
2017,Mayo,Honduras,399,479,0,878
2017,Mayo,Hong Kong,3,7,0,10
2017,Mayo,Hungría,31,48,0,79
2017,Mayo,India,122,618,0,740
2017,Mayo,Indonesia,23,35,0,58
2017,Mayo,Irán,7,21,0,28
2017,Mayo,República de Irlanda,170,276,0,446
2017,Mayo,Islandia,15,15,0,30
2017,Mayo,Israel,585,1262,0,1847
2017,Mayo,Italia,722,2033,0,2755
2017,Mayo,Jamaica,26,40,0,66
2017,Mayo,Japón,139,554,0,693
2017,Mayo,Jordania,1,9,0,10
2017,Mayo,Kazajistán,5,10,0,15
2017,Mayo,Kenia,2,7,0,9
2017,Mayo,Kiribati,0,1,0,1
2017,Mayo,Kuwait,0,2,0,2
2017,Mayo,República de Kosovo,1,2,0,3
2017,Mayo,Letonia,7,12,0,19
2017,Mayo,Lituania,23,17,0,40
2017,Mayo,Líbano,16,37,0,53
2017,Mayo,Liechtenstein,1,2,0,3
2017,Mayo,Luxemburgo,9,14,0,23
2017,Mayo,Macedonia,2,3,0,5
2017,Mayo,Madagascar,1,0,0,1
2017,Mayo,Malasia,9,30,0,39
2017,Mayo,Malawi,0,1,0,1
2017,Mayo,Malí,0,2,0,2
2017,Mayo,Malta,6,8,0,14
2017,Mayo,Marruecos,8,14,0,22
2017,Mayo,Mauricio,1,6,0,7
2017,Mayo,México,5093,8754,0,13847
2017,Mayo,República de Moldavia,9,2,0,11
2017,Mayo,Mónaco,1,0,0,1
2017,Mayo,Mongolia,1,0,0,1
2017,Mayo,Montenegro,0,4,0,4
2017,Mayo,Mozambique,0,2,0,2
2017,Mayo,Myanmar,1,2,0,3
2017,Mayo,Namibia,1,0,0,1
2017,Mayo,Nepal,0,2,0,2
2017,Mayo,Nicaragua,122,163,0,285
2017,Mayo,Nigeria,5,21,0,26
2017,Mayo,Noruega,99,150,0,249
2017,Mayo,Nueva Zelanda,116,172,0,288
2017,Mayo,Pakistán,4,24,0,28
2017,Mayo,Panamá,2800,3253,0,6053
2017,Mayo,Paraguay,413,339,0,752
2017,Mayo,Perú,5474,6479,0,11953
2017,Mayo,Palestina,0,1,0,1
2017,Mayo,Polonia,151,216,0,367
2017,Mayo,Portugal,208,525,0,733
2017,Mayo,Puerto Rico/Territorio de Estados Unidos,1,0,0,1
2017,Mayo,Qatar,0,1,0,1
2017,Mayo,Reino Unido de Gran Bretaña e Irlanda del Norte,1342,2410,0,3752
2017,Mayo,República CentroÁfricana,1,0,0,1
2017,Mayo,Federación de Rusia,176,226,0,402
2017,Mayo,República Dominicana,579,835,0,1414
2017,Mayo,Rumania,60,92,0,152
2017,Mayo,Rwanda,3,10,0,13
2017,Mayo,San Cristóbal y Nevis,0,6,0,6
2017,Mayo,San Marino,1,1,0,2
2017,Mayo,San  Vicente y las Granadinas,5,6,0,11
2017,Mayo,Santa Lucia,3,2,0,5
2017,Mayo,Santa Sede/Ciudad del Vaticano,0,5,0,5
2017,Mayo,Senegal,1,3,0,4
2017,Mayo,Serbia,10,14,0,24
2017,Mayo,Sierra Leona,0,1,0,1
2017,Mayo,Singapur,18,36,0,54
2017,Mayo,República Árabe Siria,0,2,0,2
2017,Mayo,Sri Lanka,0,4,0,4
2017,Mayo,Sudáfrica,38,63,0,101
2017,Mayo,Sudán,0,2,0,2
2017,Mayo,Suecia,176,292,0,468
2017,Mayo,Suiza,435,725,0,1160
2017,Mayo,Surinam,10,44,0,54
2017,Mayo,Taiwán,65,92,0,157
2017,Mayo,Tailandia,16,14,0,30
2017,Mayo,Tanzania,1,1,0,2
2017,Mayo,Trinidad y Tobago,27,68,0,95
2017,Mayo,Túnez,5,9,0,14
2017,Mayo,Turquía,150,301,0,451
2017,Mayo,Ucrania,27,48,0,75
2017,Mayo,Uganda,7,11,0,18
2017,Mayo,Uruguay,536,744,0,1280
2017,Mayo,Venezuela,20382,25463,0,45845
2017,Mayo,Vietnam,7,23,0,30
2017,Mayo,Zambia,5,5,0,10
2017,Mayo,Zimbabue,1,10,0,11
2017,Mayo,Anguila/Territorio Británico de Ultramar,0,1,0,1
2017,Mayo,Refugiado,2,3,0,5
2017,Mayo,Desconocido,82,147,0,229
2017,Junio,Albania,2,3,0,5
2017,Junio,Alemania,1726,2439,0,4165
2017,Junio,Andorra,3,9,0,12
2017,Junio,Antigua y Barbuda,0,3,0,3
2017,Junio,Países Bajos,1504,2011,0,3515
2017,Junio,Arabia Saudita,1,12,0,13
2017,Junio,Argelia,1,8,0,9
2017,Junio,Argentina,6021,7236,0,13257
2017,Junio,República de Armenia,3,3,0,6
2017,Junio,Australia,529,828,0,1357
2017,Junio,Austria,156,248,0,404
2017,Junio,Azerbaiyán,3,2,0,5
2017,Junio,Bahamas,5,21,0,26
2017,Junio,Bangladesh,0,2,0,2
2017,Junio,Barbados,4,12,0,16
2017,Junio,República de Belarús,6,8,0,14
2017,Junio,Bélgica,327,534,0,861
2017,Junio,Belice,10,18,0,28
2017,Junio,Bermudas/Territorio Británico de Ultramar,0,5,0,5
2017,Junio,Bolivia,872,824,0,1696
2017,Junio,Bosnia y Herzegovina,1,1,0,2
2017,Junio,Brasil,6871,7640,0,14511
2017,Junio,Bulgaria,20,37,0,57
2017,Junio,Burkina Faso,0,3,0,3
2017,Junio,Cabo Verde,1,0,0,1
2017,Junio,Islas Caimán/Territorio Británico de Ultramar,1,4,0,5
2017,Junio,Camboya,0,1,0,1
2017,Junio,Camerún,2,4,0,6
2017,Junio,Canadá,1379,2170,0,3549
2017,Junio,Chad,0,1,0,1
2017,Junio,España,3311,6611,0,9922
2017,Junio,República Democrática del Congo,1,6,0,7
2017,Junio,República de Corea,345,542,0,887
2017,Junio,Costa de Marfil,1,7,0,8
2017,Junio,Costa Rica,1473,1744,0,3217
2017,Junio,Croacia,10,49,0,59
2017,Junio,Cuba,264,489,0,753
2017,Junio,República Checa,43,59,0,102
2017,Junio,Chile,4723,5720,0,10443
2017,Junio,China,484,969,0,1453
2017,Junio,Chipre,2,5,0,7
2017,Junio,Dinamarca,134,227,0,361
2017,Junio,Dominica,1,5,0,6
2017,Junio,Ecuador,4563,6920,0,11483
2017,Junio,Egipto,2,25,0,27
2017,Junio,El Salvador,820,1059,0,1879
2017,Junio,Emiratos Árabes,3,7,0,10
2017,Junio,Eritrea,0,1,0,1
2017,Junio,Eslovaquia,26,30,0,56
2017,Junio,Eslovenia,15,34,0,49
2017,Junio,Estados Unidos de América,23200,33250,0,56450
2017,Junio,Estonia,14,12,0,26
2017,Junio,Etiopia,3,7,0,10
2017,Junio,Islas Fiji,1,1,0,2
2017,Junio,Filipinas,69,287,0,356
2017,Junio,Finlandia,69,77,0,146
2017,Junio,Francia,1790,2943,0,4733
2017,Junio,Georgia,5,11,0,16
2017,Junio,Ghana,8,9,0,17
2017,Junio,Granada,2,2,0,4
2017,Junio,Grecia,31,76,0,107
2017,Junio,Guatemala,673,1035,0,1708
2017,Junio,Guyana,8,15,0,23
2017,Junio,Guinea,1,7,0,8
2017,Junio,Haití,14,31,0,45
2017,Junio,Honduras,254,377,0,631
2017,Junio,Hong Kong,3,5,0,8
2017,Junio,Hungría,41,49,0,90
2017,Junio,India,97,492,0,589
2017,Junio,Indonesia,28,37,0,65
2017,Junio,Iraq,1,0,0,1
2017,Junio,Irán,5,10,0,15
2017,Junio,República de Irlanda,184,321,0,505
2017,Junio,Islandia,17,9,0,26
2017,Junio,Israel,359,861,0,1220
2017,Junio,Italia,791,2004,0,2795
2017,Junio,Jamaica,37,46,0,83
2017,Junio,Japón,189,528,0,717
2017,Junio,Jordania,5,9,0,14
2017,Junio,Kazajistán,4,2,0,6
2017,Junio,Kenia,8,9,0,17
2017,Junio,Kirguistán,0,2,0,2
2017,Junio,Kuwait,1,1,0,2
2017,Junio,República de Kosovo,0,1,0,1
2017,Junio,República Democrática Popular  Lao,1,1,0,2
2017,Junio,Letonia,10,10,0,20
2017,Junio,Lituania,40,25,0,65
2017,Junio,Líbano,22,25,0,47
2017,Junio,Liechtenstein,3,4,0,7
2017,Junio,Luxemburgo,2,12,0,14
2017,Junio,Macedonia,0,4,0,4
2017,Junio,Madagascar,4,0,0,4
2017,Junio,Malasia,12,33,0,45
2017,Junio,Malí,0,2,0,2
2017,Junio,Malta,6,10,0,16
2017,Junio,Marruecos,2,14,0,16
2017,Junio,Mauricio,0,4,0,4
2017,Junio,Mauritania,0,1,0,1
2017,Junio,México,5254,8750,0,14004
2017,Junio,República de Moldavia,7,2,0,9
2017,Junio,Mónaco,1,0,0,1
2017,Junio,Mongolia,5,5,0,10
2017,Junio,Montenegro,0,4,0,4
2017,Junio,Mozambique,0,1,0,1
2017,Junio,Myanmar,1,1,0,2
2017,Junio,Namibia,2,0,0,2
2017,Junio,Nepal,3,3,0,6
2017,Junio,Nicaragua,114,115,0,229
2017,Junio,Nigeria,3,12,0,15
2017,Junio,Noruega,225,317,0,542
2017,Junio,Nueva Zelanda,101,152,0,253
2017,Junio,Omán,1,2,0,3
2017,Junio,Papúa Nueva Guinea,0,1,0,1
2017,Junio,Pakistán,3,13,0,16
2017,Junio,Panamá,3535,3630,0,7165
2017,Junio,Paraguay,366,339,0,705
2017,Junio,Perú,4887,5922,0,10809
2017,Junio,Palestina,2,4,0,6
2017,Junio,Polonia,135,178,0,313
2017,Junio,Portugal,233,461,0,694
2017,Junio,Puerto Rico/Territorio de Estados Unidos,1,0,0,1
2017,Junio,Qatar,0,1,0,1
2017,Junio,Reino Unido de Gran Bretaña e Irlanda del Norte,1525,2564,0,4089
2017,Junio,República CentroÁfricana,1,0,0,1
2017,Junio,Federación de Rusia,178,219,0,397
2017,Junio,República Dominicana,611,848,0,1459
2017,Junio,Rumania,60,95,0,155
2017,Junio,San Cristóbal y Nevis,0,3,0,3
2017,Junio,San Marino,0,2,0,2
2017,Junio,San  Vicente y las Granadinas,0,1,0,1
2017,Junio,Santa Lucia,2,2,0,4
2017,Junio,Santa Sede/Ciudad del Vaticano,0,2,0,2
2017,Junio,Senegal,1,0,0,1
2017,Junio,Serbia,4,19,0,23
2017,Junio,Sierra Leona,0,2,0,2
2017,Junio,Singapur,24,34,0,58
2017,Junio,República Árabe Siria,1,2,0,3
2017,Junio,Sri Lanka,1,2,0,3
2017,Junio,Sudáfrica,43,103,0,146
2017,Junio,Sudán,0,1,0,1
2017,Junio,Suecia,300,453,0,753
2017,Junio,Suiza,522,794,0,1316
2017,Junio,Surinam,7,21,0,28
2017,Junio,Taiwán,64,98,0,162
2017,Junio,Tailandia,44,30,0,74
2017,Junio,Tanzania,2,2,0,4
2017,Junio,Togo,0,1,0,1
2017,Junio,Trinidad y Tobago,38,65,0,103
2017,Junio,Túnez,3,10,0,13
2017,Junio,Turquía,165,332,0,497
2017,Junio,Ucrania,22,42,0,64
2017,Junio,Uganda,2,0,0,2
2017,Junio,Uruguay,673,883,0,1556
2017,Junio,Uzbekistán,2,0,0,2
2017,Junio,Venezuela,20964,26124,0,47088
2017,Junio,Vietnam,11,4,0,15
2017,Junio,República Árabe de Yemen,0,1,0,1
2017,Junio,Zambia,1,4,0,5
2017,Junio,Zimbabue,1,9,0,10
2017,Junio,Anguila/Territorio Británico de Ultramar,1,0,0,1
2017,Junio,Refugiado,1,3,0,4
2017,Junio,Desconocido,100,203,0,303
2017,Julio,Afganistán,0,2,0,2
2017,Julio,Albania,1,3,0,4
2017,Julio,Alemania,2842,3426,0,6268
2017,Julio,Andorra,1,11,0,12
2017,Julio,Angola,2,8,0,10
2017,Julio,Antigua y Barbuda,1,6,0,7
2017,Julio,Países Bajos,3359,3924,0,7283
2017,Julio,Arabia Saudita,0,9,0,9
2017,Julio,Argelia,4,9,0,13
2017,Julio,Argentina,8662,8946,0,17608
2017,Julio,República de Armenia,1,4,0,5
2017,Julio,Australia,613,923,0,1536
2017,Julio,Austria,371,435,0,806
2017,Julio,Azerbaiyán,4,9,0,13
2017,Julio,Bahamas,21,15,0,36
2017,Julio,Bahréin,1,4,0,5
2017,Julio,Bangladesh,3,6,0,9
2017,Julio,Barbados,46,60,0,106
2017,Julio,República de Belarús,2,5,0,7
2017,Julio,Bélgica,754,928,0,1682
2017,Julio,Belice,16,25,0,41
2017,Julio,Benín,1,1,0,2
2017,Julio,Bermudas/Territorio Británico de Ultramar,0,9,0,9
2017,Julio,Bolivia,990,986,0,1976
2017,Julio,Bosnia y Herzegovina,1,2,0,3
2017,Julio,Brasil,8719,9371,0,18090
2017,Julio,Brunei Darussalam,2,0,0,2
2017,Julio,Bulgaria,27,31,0,58
2017,Julio,Burundi,0,1,0,1
2017,Julio,Bután,0,3,0,3
2017,Julio,Islas Caimán/Territorio Británico de Ultramar,5,2,0,7
2017,Julio,Camboya,0,4,0,4
2017,Julio,Camerún,7,19,0,26
2017,Julio,Canadá,1743,2495,0,4238
2017,Julio,España,4197,7268,0,11465
2017,Julio,República Del Congo,0,1,0,1
2017,Julio,República Democrática del Congo,3,4,0,7
2017,Julio,República de Corea,278,510,0,788
2017,Julio,Costa de Marfil,1,6,0,7
2017,Julio,Costa Rica,1902,2025,0,3927
2017,Julio,Croacia,17,38,0,55
2017,Julio,Cuba,347,539,0,886
2017,Julio,República Checa,91,105,0,196
2017,Julio,Chile,6247,6622,0,12869
2017,Julio,China,551,945,0,1496
2017,Julio,Chipre,6,12,0,18
2017,Julio,Dinamarca,252,350,0,602
2017,Julio,Dominica,3,7,0,10
2017,Julio,Ecuador,6578,8564,0,15142
2017,Julio,Egipto,10,49,0,59
2017,Julio,El Salvador,994,1190,0,2184
2017,Julio,Emiratos Árabes,9,17,0,26
2017,Julio,Eritrea,0,1,0,1
2017,Julio,Eslovaquia,36,39,0,75
2017,Julio,Eslovenia,39,46,0,85
2017,Julio,Estados Unidos de América,22627,31883,0,54510
2017,Julio,Estonia,17,19,0,36
2017,Julio,Etiopia,2,4,0,6
2017,Julio,Islas Fiji,1,2,0,3
2017,Julio,Filipinas,76,195,0,271
2017,Julio,Finlandia,66,88,0,154
2017,Julio,Francia,3759,4905,0,8664
2017,Julio,Gabón,2,1,0,3
2017,Julio,Georgia,5,4,0,9
2017,Julio,Ghana,8,11,0,19
2017,Julio,Granada,2,6,0,8
2017,Julio,Grecia,51,83,0,134
2017,Julio,Guatemala,569,1079,0,1648
2017,Julio,Guyana,23,20,0,43
2017,Julio,Guinea,1,0,0,1
2017,Julio,Guinea Ecuatorial,0,2,0,2
2017,Julio,Haití,8,21,0,29
2017,Julio,Honduras,356,534,0,890
2017,Julio,Hong Kong,9,4,0,13
2017,Julio,Hungría,53,64,0,117
2017,Julio,India,146,569,0,715
2017,Julio,Indonesia,29,47,0,76
2017,Julio,Iraq,1,3,0,4
2017,Julio,Irán,8,16,0,24
2017,Julio,República de Irlanda,308,397,0,705
2017,Julio,Islandia,14,22,0,36
2017,Julio,Israel,340,732,0,1072
2017,Julio,Italia,1231,2304,0,3535
2017,Julio,Jamaica,42,54,0,96
2017,Julio,Japón,161,496,0,657
2017,Julio,Jordania,4,10,0,14
2017,Julio,Kazajistán,1,5,0,6
2017,Julio,Kenia,14,16,0,30
2017,Julio,Kiribati,0,6,0,6
2017,Julio,Kuwait,6,3,0,9
2017,Julio,República de Kosovo,0,2,0,2
2017,Julio,República Democrática Popular  Lao,2,2,0,4
2017,Julio,Lesoto,0,1,0,1
2017,Julio,Letonia,10,12,0,22
2017,Julio,Lituania,25,24,0,49
2017,Julio,Líbano,31,31,0,62
2017,Julio,Liberia,0,1,0,1
2017,Julio,Liechtenstein,9,6,0,15
2017,Julio,Luxemburgo,19,17,0,36
2017,Julio,Macedonia,2,3,0,5
2017,Julio,Madagascar,3,2,0,5
2017,Julio,Malasia,16,34,0,50
2017,Julio,Malawi,2,0,0,2
2017,Julio,Maldivas,0,1,0,1
2017,Julio,Malta,8,10,0,18
2017,Julio,Marruecos,20,15,0,35
2017,Julio,Mauricio,1,6,0,7
2017,Julio,México,7253,10597,0,17850
2017,Julio,República de Moldavia,2,0,0,2
2017,Julio,Mónaco,1,0,0,1
2017,Julio,Mongolia,3,2,0,5
2017,Julio,Montenegro,1,3,0,4
2017,Julio,Mozambique,1,3,0,4
2017,Julio,Myanmar,4,10,0,14
2017,Julio,Namibia,1,0,0,1
2017,Julio,Nepal,3,11,0,14
2017,Julio,Nicaragua,124,231,0,355
2017,Julio,Nigeria,11,16,0,27
2017,Julio,Noruega,275,325,0,600
2017,Julio,Nueva Zelanda,173,209,0,382
2017,Julio,Omán,0,2,0,2
2017,Julio,Papúa Nueva Guinea,0,2,0,2
2017,Julio,Pakistán,14,23,0,37
2017,Julio,Panamá,3256,3505,0,6761
2017,Julio,Paraguay,255,227,0,482
2017,Julio,Perú,6367,6904,0,13271
2017,Julio,Palestina,0,2,0,2
2017,Julio,Polonia,210,205,0,415
2017,Julio,Portugal,312,550,0,862
2017,Julio,Qatar,0,2,0,2
2017,Julio,Reino Unido de Gran Bretaña e Irlanda del Norte,1943,3002,0,4945
2017,Julio,República CentroÁfricana,0,1,0,1
2017,Julio,Federación de Rusia,182,194,0,376
2017,Julio,República Dominicana,694,926,0,1620
2017,Julio,Rumania,91,86,0,177
2017,Julio,Rwanda,0,2,0,2
2017,Julio,San Cristóbal y Nevis,1,6,0,7
2017,Julio,San Marino,1,1,0,2
2017,Julio,San  Vicente y las Granadinas,6,5,0,11
2017,Julio,Santa Lucia,7,5,0,12
2017,Julio,Senegal,0,1,0,1
2017,Julio,Serbia,14,14,0,28
2017,Julio,Sierra Leona,1,0,0,1
2017,Julio,Singapur,25,29,0,54
2017,Julio,República Árabe Siria,1,1,0,2
2017,Julio,Sri Lanka,0,9,0,9
2017,Julio,Sudáfrica,80,131,0,211
2017,Julio,Sudán,1,1,0,2
2017,Julio,Suecia,224,380,0,604
2017,Julio,Suiza,1105,1376,0,2481
2017,Julio,Surinam,23,29,0,52
2017,Julio,Taiwán,90,116,0,206
2017,Julio,Tailandia,33,8,0,41
2017,Julio,Tanzania,2,5,0,7
2017,Julio,Togo,1,4,0,5
2017,Julio,Trinidad y Tobago,61,88,0,149
2017,Julio,Túnez,4,10,0,14
2017,Julio,Turquía,168,287,0,455
2017,Julio,Ucrania,34,39,0,73
2017,Julio,Uganda,1,5,0,6
2017,Julio,Uruguay,654,753,0,1407
2017,Julio,Uzbekistán,0,1,0,1
2017,Julio,Venezuela,35498,38805,0,74303
2017,Julio,Vietnam,14,18,0,32
2017,Julio,Islas Vírgenes Británicas/Territorio Británico de Ultramar,0,1,0,1
2017,Julio,Zimbabue,1,9,0,10
2017,Julio,Anguila/Territorio Británico de Ultramar,0,1,0,1
2017,Julio,Islas Turcas y Caicos/Territorio Británico de Ultramar,1,0,0,1
2017,Julio,Refugiado,2,1,0,3
2017,Julio,Desconocido,85,169,0,254
2017,Agosto,Afganistán,0,1,0,1
2017,Agosto,Albania,5,2,0,7
2017,Agosto,Alemania,2924,3632,0,6556
2017,Agosto,Andorra,6,18,0,24
2017,Agosto,Angola,4,1,0,5
2017,Agosto,Antigua y Barbuda,0,4,0,4
2017,Agosto,Países Bajos,1990,2556,0,4546
2017,Agosto,Arabia Saudita,0,16,0,16
2017,Agosto,Argelia,8,13,0,21
2017,Agosto,Argentina,6799,7881,0,14680
2017,Agosto,República de Armenia,2,1,0,3
2017,Agosto,Australia,496,815,0,1311
2017,Agosto,Austria,286,363,0,649
2017,Agosto,Azerbaiyán,2,8,0,10
2017,Agosto,Bahamas,15,27,0,42
2017,Agosto,Bahréin,0,2,0,2
2017,Agosto,Bangladesh,1,2,0,3
2017,Agosto,Barbados,12,14,0,26
2017,Agosto,República de Belarús,3,7,0,10
2017,Agosto,Bélgica,428,617,0,1045
2017,Agosto,Belice,14,23,0,37
2017,Agosto,Bermudas/Territorio Británico de Ultramar,5,7,0,12
2017,Agosto,Bolivia,870,917,0,1787
2017,Agosto,Bosnia y Herzegovina,2,3,0,5
2017,Agosto,Brasil,8387,9343,0,17730
2017,Agosto,Brunei Darussalam,0,1,0,1
2017,Agosto,Bulgaria,19,30,0,49
2017,Agosto,Burkina Faso,2,0,0,2
2017,Agosto,Burundi,0,1,0,1
2017,Agosto,Bután,0,1,0,1
2017,Agosto,Cabo Verde,1,2,0,3
2017,Agosto,Islas Caimán/Territorio Británico de Ultramar,3,3,0,6
2017,Agosto,Camboya,0,1,0,1
2017,Agosto,Camerún,1,4,0,5
2017,Agosto,Canadá,1531,2368,0,3899
2017,Agosto,Chad,0,1,0,1
2017,Agosto,España,5472,8222,0,13694
2017,Agosto,República Democrática del Congo,0,2,0,2
2017,Agosto,República de Corea,254,486,0,740
2017,Agosto,Costa de Marfil,0,1,0,1
2017,Agosto,Costa Rica,1340,1833,0,3173
2017,Agosto,Croacia,19,40,0,59
2017,Agosto,Cuba,285,635,0,920
2017,Agosto,República Checa,67,72,0,139
2017,Agosto,Chile,5873,6696,0,12569
2017,Agosto,China,442,931,0,1373
2017,Agosto,Chipre,5,12,0,17
2017,Agosto,Dinamarca,110,184,0,294
2017,Agosto,Dominica,1,7,0,8
2017,Agosto,Ecuador,9503,10764,0,20267
2017,Agosto,Egipto,6,23,0,29
2017,Agosto,El Salvador,1188,1372,0,2560
2017,Agosto,Emiratos Árabes,8,20,0,28
2017,Agosto,Eritrea,0,2,0,2
2017,Agosto,Eslovaquia,26,38,0,64
2017,Agosto,Eslovenia,12,32,0,44
2017,Agosto,Estados Unidos de América,18199,30919,0,49118
2017,Agosto,Estonia,9,9,0,18
2017,Agosto,Etiopia,2,3,0,5
2017,Agosto,Filipinas,59,315,0,374
2017,Agosto,Finlandia,66,79,0,145
2017,Agosto,Francia,3267,4531,0,7798
2017,Agosto,Gabón,1,0,0,1
2017,Agosto,Georgia,5,7,0,12
2017,Agosto,Ghana,0,9,0,9
2017,Agosto,Granada,3,5,0,8
2017,Agosto,Grecia,31,87,0,118
2017,Agosto,Guatemala,594,1156,0,1750
2017,Agosto,Guyana,7,18,0,25
2017,Agosto,Guinea Ecuatorial,0,3,0,3
2017,Agosto,Guinea Bissau,0,2,0,2
2017,Agosto,Haití,9,30,0,39
2017,Agosto,Honduras,381,544,0,925
2017,Agosto,Hong Kong,3,3,0,6
2017,Agosto,Hungría,28,61,0,89
2017,Agosto,India,108,533,0,641
2017,Agosto,Indonesia,13,28,0,41
2017,Agosto,Iraq,0,1,0,1
2017,Agosto,Irán,13,27,0,40
2017,Agosto,República de Irlanda,217,330,0,547
2017,Agosto,Islandia,7,12,0,19
2017,Agosto,Israel,304,714,0,1018
2017,Agosto,Italia,1881,3486,0,5367
2017,Agosto,Jamaica,26,50,0,76
2017,Agosto,Japón,252,571,0,823
2017,Agosto,Jordania,4,7,0,11
2017,Agosto,Kazajistán,5,3,0,8
2017,Agosto,Kenia,14,20,0,34
2017,Agosto,Kuwait,0,4,0,4
2017,Agosto,República de Kosovo,0,1,0,1
2017,Agosto,Letonia,13,14,0,27
2017,Agosto,Lituania,23,21,0,44
2017,Agosto,Líbano,33,39,0,72
2017,Agosto,Libia,0,1,0,1
2017,Agosto,Liechtenstein,5,1,0,6
2017,Agosto,Luxemburgo,15,29,0,44
2017,Agosto,Macedonia,1,0,0,1
2017,Agosto,Madagascar,1,3,0,4
2017,Agosto,Malasia,19,15,0,34
2017,Agosto,Malawi,0,3,0,3
2017,Agosto,Malta,21,15,0,36
2017,Agosto,Marruecos,9,21,0,30
2017,Agosto,Mauricio,1,4,0,5
2017,Agosto,México,6144,10495,0,16639
2017,Agosto,República de Moldavia,3,1,0,4
2017,Agosto,Mónaco,2,1,0,3
2017,Agosto,Mongolia,3,0,0,3
2017,Agosto,Montenegro,0,2,0,2
2017,Agosto,Mozambique,1,2,0,3
2017,Agosto,Myanmar,0,2,0,2
2017,Agosto,Nepal,0,6,0,6
2017,Agosto,Nicaragua,120,194,0,314
2017,Agosto,Nigeria,6,13,0,19
2017,Agosto,Noruega,93,149,0,242
2017,Agosto,Nueva Zelanda,119,181,0,300
2017,Agosto,Pakistán,4,24,0,28
2017,Agosto,Panamá,3463,3895,0,7358
2017,Agosto,Paraguay,448,354,0,802
2017,Agosto,Perú,6278,7243,0,13521
2017,Agosto,Palestina,0,5,0,5
2017,Agosto,Polonia,164,219,0,383
2017,Agosto,Portugal,317,621,0,938
2017,Agosto,Reino Unido de Gran Bretaña e Irlanda del Norte,1737,2778,0,4515
2017,Agosto,Federación de Rusia,182,213,0,395
2017,Agosto,República Dominicana,757,1148,0,1905
2017,Agosto,Rumania,69,85,0,154
2017,Agosto,Rwanda,1,2,0,3
2017,Agosto,San Cristóbal y Nevis,0,5,0,5
2017,Agosto,San Marino,4,3,0,7
2017,Agosto,San  Vicente y las Granadinas,2,2,0,4
2017,Agosto,Santa Lucia,2,4,0,6
2017,Agosto,Santa Sede/Ciudad del Vaticano,0,6,0,6
2017,Agosto,Senegal,3,2,0,5
2017,Agosto,Serbia,17,14,0,31
2017,Agosto,Singapur,28,38,0,66
2017,Agosto,República Árabe Siria,0,4,0,4
2017,Agosto,Sri Lanka,1,1,0,2
2017,Agosto,Sudáfrica,38,96,0,134
2017,Agosto,Sudán,0,2,0,2
2017,Agosto,Suecia,151,240,0,391
2017,Agosto,Suiza,559,865,0,1424
2017,Agosto,Surinam,12,18,0,30
2017,Agosto,Suazilandia,2,5,0,7
2017,Agosto,Taiwán,77,84,0,161
2017,Agosto,Tailandia,17,12,0,29
2017,Agosto,Tanzania,1,0,0,1
2017,Agosto,Trinidad y Tobago,42,73,0,115
2017,Agosto,Túnez,0,8,0,8
2017,Agosto,Turquía,234,388,0,622
2017,Agosto,Ucrania,20,73,0,93
2017,Agosto,Uganda,2,2,0,4
2017,Agosto,Uruguay,865,1040,0,1905
2017,Agosto,Uzbekistán,1,0,0,1
2017,Agosto,Venezuela,42358,46764,0,89122
2017,Agosto,Vietnam,6,3,0,9
2017,Agosto,Islas Vírgenes Británicas/Territorio Británico de Ultramar,0,1,0,1
2017,Agosto,República Árabe de Yemen,0,3,0,3
2017,Agosto,Zambia,1,0,0,1
2017,Agosto,Zimbabue,1,5,0,6
2017,Agosto,Refugiado,1,2,0,3
2017,Agosto,Desconocido,64,125,0,189
2017,Septiembre,Afganistán,0,1,0,1
2017,Septiembre,Albania,1,4,0,5
2017,Septiembre,Alemania,2008,2921,0,4929
2017,Septiembre,Andorra,1,8,0,9
2017,Septiembre,Angola,1,1,0,2
2017,Septiembre,Antigua y Barbuda,2,2,0,4
2017,Septiembre,Países Bajos,1468,2198,0,3666
2017,Septiembre,Arabia Saudita,3,8,0,11
2017,Septiembre,Argelia,1,7,0,8
2017,Septiembre,Argentina,6405,7381,0,13786
2017,Septiembre,República de Armenia,3,1,0,4
2017,Septiembre,Aruba,2,2,0,4
2017,Septiembre,Australia,461,727,0,1188
2017,Septiembre,Austria,170,333,0,503
2017,Septiembre,Azerbaiyán,2,5,0,7
2017,Septiembre,Bahamas,17,20,0,37
2017,Septiembre,Bangladesh,1,5,0,6
2017,Septiembre,Barbados,12,18,0,30
2017,Septiembre,República de Belarús,8,4,0,12
2017,Septiembre,Bélgica,332,619,0,951
2017,Septiembre,Belice,8,13,0,21
2017,Septiembre,Bermudas/Territorio Británico de Ultramar,0,5,0,5
2017,Septiembre,Bolivia,1065,1027,0,2092
2017,Septiembre,Bosnia y Herzegovina,0,4,0,4
2017,Septiembre,Brasil,10437,10810,0,21247
2017,Septiembre,Bulgaria,25,32,0,57
2017,Septiembre,Burkina Faso,0,1,0,1
2017,Septiembre,Bután,0,1,0,1
2017,Septiembre,Cabo Verde,1,2,0,3
2017,Septiembre,Islas Caimán/Territorio Británico de Ultramar,4,5,0,9
2017,Septiembre,Camboya,0,6,0,6
2017,Septiembre,Camerún,0,3,0,3
2017,Septiembre,Canadá,1037,1898,0,2935
2017,Septiembre,España,3242,6848,0,10090
2017,Septiembre,República Del Congo,0,1,0,1
2017,Septiembre,República Democrática del Congo,1,3,0,4
2017,Septiembre,República de Corea,189,484,0,673
2017,Septiembre,Costa de Marfil,0,3,0,3
2017,Septiembre,Costa Rica,1714,1807,0,3521
2017,Septiembre,Croacia,17,105,0,122
2017,Septiembre,Cuba,262,555,0,817
2017,Septiembre,República Checa,85,83,0,168
2017,Septiembre,Chile,5120,6007,0,11127
2017,Septiembre,China,382,972,0,1354
2017,Septiembre,Chipre,5,21,0,26
2017,Septiembre,Dinamarca,86,184,0,270
2017,Septiembre,Dominica,3,9,0,12
2017,Septiembre,Ecuador,6332,8621,0,14953
2017,Septiembre,Egipto,12,33,0,45
2017,Septiembre,El Salvador,1049,1270,0,2319
2017,Septiembre,Emiratos Árabes,11,23,0,34
2017,Septiembre,Eslovaquia,42,51,0,93
2017,Septiembre,Eslovenia,11,22,0,33
2017,Septiembre,Estados Unidos de América,11801,22058,0,33859
2017,Septiembre,Estonia,11,10,0,21
2017,Septiembre,Etiopia,0,3,0,3
2017,Septiembre,Filipinas,58,342,0,400
2017,Septiembre,Finlandia,39,59,0,98
2017,Septiembre,Francia,1695,2859,0,4554
2017,Septiembre,Gabón,0,1,0,1
2017,Septiembre,Gambia,1,0,0,1
2017,Septiembre,Georgia,1,4,0,5
2017,Septiembre,Ghana,1,7,0,8
2017,Septiembre,Granada,1,3,0,4
2017,Septiembre,Grecia,33,101,0,134
2017,Septiembre,Guatemala,772,1129,0,1901
2017,Septiembre,Guyana,18,30,0,48
2017,Septiembre,Haití,11,13,0,24
2017,Septiembre,Honduras,517,529,0,1046
2017,Septiembre,Hong Kong,6,8,0,14
2017,Septiembre,Hungría,58,63,0,121
2017,Septiembre,India,84,543,0,627
2017,Septiembre,Indonesia,18,60,0,78
2017,Septiembre,Iraq,0,2,0,2
2017,Septiembre,Irán,6,14,0,20
2017,Septiembre,República de Irlanda,199,306,0,505
2017,Septiembre,Islandia,5,15,0,20
2017,Septiembre,Isla de Man,0,1,0,1
2017,Septiembre,Israel,262,780,0,1042
2017,Septiembre,Italia,957,2328,0,3285
2017,Septiembre,Jamaica,27,61,0,88
2017,Septiembre,Japón,176,586,0,762
2017,Septiembre,Jordania,4,12,0,16
2017,Septiembre,Kazajistán,3,6,0,9
2017,Septiembre,Kenia,9,15,0,24
2017,Septiembre,Kuwait,3,1,0,4
2017,Septiembre,República de Kosovo,3,0,0,3
2017,Septiembre,República Democrática Popular  Lao,2,0,0,2
2017,Septiembre,Lesoto,1,1,0,2
2017,Septiembre,Letonia,9,15,0,24
2017,Septiembre,Lituania,29,25,0,54
2017,Septiembre,Líbano,23,22,0,45
2017,Septiembre,Liechtenstein,1,1,0,2
2017,Septiembre,Luxemburgo,5,8,0,13
2017,Septiembre,Macedonia,1,3,0,4
2017,Septiembre,Madagascar,4,1,0,5
2017,Septiembre,Malasia,12,37,0,49
2017,Septiembre,Malawi,0,2,0,2
2017,Septiembre,Malta,7,12,0,19
2017,Septiembre,Marruecos,12,27,0,39
2017,Septiembre,Mauricio,5,4,0,9
2017,Septiembre,México,5625,9860,0,15485
2017,Septiembre,República de Moldavia,3,3,0,6
2017,Septiembre,Mónaco,0,1,0,1
2017,Septiembre,Montenegro,0,6,0,6
2017,Septiembre,Mozambique,1,5,0,6
2017,Septiembre,Myanmar,0,3,0,3
2017,Septiembre,Namibia,0,1,0,1
2017,Septiembre,Nepal,5,5,0,10
2017,Septiembre,Nicaragua,151,185,0,336
2017,Septiembre,Nigeria,6,13,0,19
2017,Septiembre,Noruega,135,144,0,279
2017,Septiembre,Nueva Zelanda,121,158,0,279
2017,Septiembre,Omán,5,3,0,8
2017,Septiembre,Papúa Nueva Guinea,0,1,0,1
2017,Septiembre,Pakistán,5,19,0,24
2017,Septiembre,Panamá,5312,4569,0,9881
2017,Septiembre,Paraguay,384,541,0,925
2017,Septiembre,Perú,5440,6418,0,11858
2017,Septiembre,Palestina,0,2,0,2
2017,Septiembre,Polonia,190,243,0,433
2017,Septiembre,Portugal,230,577,0,807
2017,Septiembre,Puerto Rico/Territorio de Estados Unidos,2,2,0,4
2017,Septiembre,Qatar,0,1,0,1
2017,Septiembre,Reino Unido de Gran Bretaña e Irlanda del Norte,1194,2308,0,3502
2017,Septiembre,Federación de Rusia,176,225,0,401
2017,Septiembre,República Dominicana,635,848,0,1483
2017,Septiembre,Rumania,82,96,0,178
2017,Septiembre,Rwanda,0,5,0,5
2017,Septiembre,San Cristóbal y Nevis,3,0,0,3
2017,Septiembre,Samoa Occidental,0,1,0,1
2017,Septiembre,San  Vicente y las Granadinas,0,4,0,4
2017,Septiembre,Santa Lucia,4,3,0,7
2017,Septiembre,Santa Sede/Ciudad del Vaticano,0,11,0,11
2017,Septiembre,Santo Tomé y Príncipe,0,1,0,1
2017,Septiembre,Senegal,0,2,0,2
2017,Septiembre,Serbia,7,6,0,13
2017,Septiembre,Sierra Leona,0,2,0,2
2017,Septiembre,Singapur,16,34,0,50
2017,Septiembre,República Árabe Siria,1,1,0,2
2017,Septiembre,Sri Lanka,1,7,0,8
2017,Septiembre,Sudáfrica,31,78,0,109
2017,Septiembre,Suecia,148,295,0,443
2017,Septiembre,Suiza,456,777,0,1233
2017,Septiembre,Surinam,17,20,0,37
2017,Septiembre,Taiwán,46,83,0,129
2017,Septiembre,Tailandia,6,14,0,20
2017,Septiembre,Tanzania,1,5,0,6
2017,Septiembre,Togo,0,1,0,1
2017,Septiembre,Tonga,1,0,0,1
2017,Septiembre,Trinidad y Tobago,43,87,0,130
2017,Septiembre,Túnez,1,11,0,12
2017,Septiembre,Turquía,169,326,0,495
2017,Septiembre,Ucrania,36,40,0,76
2017,Septiembre,Uganda,5,5,0,10
2017,Septiembre,Uruguay,622,823,0,1445
2017,Septiembre,Vanuatu,0,1,0,1
2017,Septiembre,Venezuela,37120,42194,0,79314
2017,Septiembre,Vietnam,8,7,0,15
2017,Septiembre,República Árabe de Yemen,0,1,0,1
2017,Septiembre,Zambia,1,3,0,4
2017,Septiembre,Zimbabue,2,4,0,6
2017,Septiembre,Islas Turcas y Caicos/Territorio Británico de Ultramar,1,0,0,1
2017,Septiembre,Refugiado,1,5,0,6
2017,Septiembre,Desconocido,116,191,0,307
2017,Octubre,Afganistán,1,7,0,8
2017,Octubre,Albania,2,4,0,6
2017,Octubre,Alemania,2197,3326,0,5523
2017,Octubre,Andorra,3,12,0,15
2017,Octubre,Angola,2,1,0,3
2017,Octubre,Antigua y Barbuda,1,5,0,6
2017,Octubre,Países Bajos,1709,2465,0,4174
2017,Octubre,Arabia Saudita,6,9,0,15
2017,Octubre,Argelia,2,5,0,7
2017,Octubre,Argentina,6230,7649,0,13879
2017,Octubre,República de Armenia,0,2,0,2
2017,Octubre,Australia,509,804,0,1313
2017,Octubre,Austria,208,339,0,547
2017,Octubre,Azerbaiyán,4,8,0,12
2017,Octubre,Bahamas,11,21,0,32
2017,Octubre,Bahréin,1,2,0,3
2017,Octubre,Bangladesh,11,11,0,22
2017,Octubre,Barbados,11,15,0,26
2017,Octubre,República de Belarús,5,3,0,8
2017,Octubre,Bélgica,325,544,0,869
2017,Octubre,Belice,9,21,0,30
2017,Octubre,Benín,2,6,0,8
2017,Octubre,Bermudas/Territorio Británico de Ultramar,1,3,0,4
2017,Octubre,Bolivia,901,955,0,1856
2017,Octubre,Bosnia y Herzegovina,0,5,0,5
2017,Octubre,Botsuana,1,2,0,3
2017,Octubre,Brasil,10873,11294,0,22167
2017,Octubre,Brunei Darussalam,1,0,0,1
2017,Octubre,Bulgaria,44,56,0,100
2017,Octubre,Burkina Faso,0,3,0,3
2017,Octubre,Burundi,0,1,0,1
2017,Octubre,Bután,0,3,0,3
2017,Octubre,Cabo Verde,0,3,0,3
2017,Octubre,Islas Caimán/Territorio Británico de Ultramar,1,0,0,1
2017,Octubre,Camboya,2,2,0,4
2017,Octubre,Camerún,1,8,0,9
2017,Octubre,Canadá,1330,2258,0,3588
2017,Octubre,Chad,0,1,0,1
2017,Octubre,España,3583,7173,0,10756
2017,Octubre,República Del Congo,1,1,0,2
2017,Octubre,Comoras,0,1,0,1
2017,Octubre,República Democrática del Congo,4,5,0,9
2017,Octubre,República de Corea,286,525,0,811
2017,Octubre,Costa de Marfil,2,12,0,14
2017,Octubre,Costa Rica,1447,1800,0,3247
2017,Octubre,Croacia,23,62,0,85
2017,Octubre,Cuba,354,658,0,1012
2017,Octubre,República Checa,76,114,0,190
2017,Octubre,Chile,5697,6355,0,12052
2017,Octubre,China,480,884,0,1364
2017,Octubre,Chipre,4,5,0,9
2017,Octubre,Dinamarca,120,233,0,353
2017,Octubre,República de Yibuti,0,1,0,1
2017,Octubre,Dominica,1,2,0,3
2017,Octubre,Ecuador,5669,8428,0,14097
2017,Octubre,Egipto,10,33,0,43
2017,Octubre,El Salvador,1004,1364,0,2368
2017,Octubre,Emiratos Árabes,5,23,0,28
2017,Octubre,Eslovaquia,36,57,0,93
2017,Octubre,Eslovenia,24,51,0,75
2017,Octubre,Estados Unidos de América,11817,22746,0,34563
2017,Octubre,Estonia,13,15,0,28
2017,Octubre,Etiopia,1,4,0,5
2017,Octubre,Islas Fiji,0,1,0,1
2017,Octubre,Filipinas,73,243,0,316
2017,Octubre,Finlandia,63,102,0,165
2017,Octubre,Francia,1910,3109,0,5019
2017,Octubre,Gabón,0,3,0,3
2017,Octubre,Gambia,0,1,0,1
2017,Octubre,Georgia,7,8,0,15
2017,Octubre,Ghana,8,28,0,36
2017,Octubre,Granada,1,4,0,5
2017,Octubre,Grecia,42,100,0,142
2017,Octubre,Guatemala,735,1176,0,1911
2017,Octubre,Guyana,12,29,0,41
2017,Octubre,Guinea,0,2,0,2
2017,Octubre,Guinea Ecuatorial,0,2,0,2
2017,Octubre,Guinea Bissau,0,2,0,2
2017,Octubre,Haití,17,30,0,47
2017,Octubre,Honduras,439,554,0,993
2017,Octubre,Hong Kong,6,11,0,17
2017,Octubre,Hungría,61,100,0,161
2017,Octubre,India,96,504,0,600
2017,Octubre,Indonesia,10,17,0,27
2017,Octubre,Iraq,1,0,0,1
2017,Octubre,Irán,8,15,0,23
2017,Octubre,República de Irlanda,176,323,0,499
2017,Octubre,Islandia,4,9,0,13
2017,Octubre,Israel,195,593,0,788
2017,Octubre,Italia,899,2433,0,3332
2017,Octubre,Jamaica,47,61,0,108
2017,Octubre,Islas Salomón,0,1,0,1
2017,Octubre,Japón,178,606,0,784
2017,Octubre,Jordania,3,12,0,15
2017,Octubre,Kazajistán,7,10,0,17
2017,Octubre,Kenia,16,16,0,32
2017,Octubre,Kiribati,0,1,0,1
2017,Octubre,Kirguistán,1,1,0,2
2017,Octubre,Kuwait,0,2,0,2
2017,Octubre,República de Kosovo,1,0,0,1
2017,Octubre,República Democrática Popular  Lao,1,0,0,1
2017,Octubre,Lesoto,1,1,0,2
2017,Octubre,Letonia,7,24,0,31
2017,Octubre,Lituania,32,39,0,71
2017,Octubre,Líbano,22,31,0,53
2017,Octubre,Liberia,1,2,0,3
2017,Octubre,Libia,1,1,0,2
2017,Octubre,Liechtenstein,2,4,0,6
2017,Octubre,Luxemburgo,11,12,0,23
2017,Octubre,Macedonia,0,9,0,9
2017,Octubre,Madagascar,3,0,0,3
2017,Octubre,Malasia,26,37,0,63
2017,Octubre,Malawi,1,1,0,2
2017,Octubre,Maldivas,1,0,0,1
2017,Octubre,Malí,1,3,0,4
2017,Octubre,Malta,4,12,0,16
2017,Octubre,Marruecos,15,17,0,32
2017,Octubre,Islas Marshall,1,0,0,1
2017,Octubre,Mauricio,2,9,0,11
2017,Octubre,México,5924,9815,0,15739
2017,Octubre,República de Moldavia,5,5,0,10
2017,Octubre,Mónaco,0,1,0,1
2017,Octubre,Mongolia,2,1,0,3
2017,Octubre,Montenegro,3,8,0,11
2017,Octubre,Micronesia,1,0,0,1
2017,Octubre,Mozambique,1,4,0,5
2017,Octubre,Myanmar,9,20,0,29
2017,Octubre,Nauru,1,0,0,1
2017,Octubre,Namibia,1,1,0,2
2017,Octubre,Nepal,6,7,0,13
2017,Octubre,Nicaragua,141,199,0,340
2017,Octubre,Nigeria,11,21,0,32
2017,Octubre,Noruega,134,171,0,305
2017,Octubre,Nueva Zelanda,100,186,0,286
2017,Octubre,Omán,1,5,0,6
2017,Octubre,Papúa Nueva Guinea,0,2,0,2
2017,Octubre,Pakistán,12,21,0,33
2017,Octubre,Palau,1,0,0,1
2017,Octubre,Panamá,3782,3994,0,7776
2017,Octubre,Paraguay,360,417,0,777
2017,Octubre,Perú,6733,7886,0,14619
2017,Octubre,Palestina,2,1,0,3
2017,Octubre,Polonia,178,259,0,437
2017,Octubre,Portugal,306,637,0,943
2017,Octubre,Qatar,0,2,0,2
2017,Octubre,Reino Unido de Gran Bretaña e Irlanda del Norte,1250,2503,0,3753
2017,Octubre,Federación de Rusia,228,321,0,549
2017,Octubre,República Dominicana,762,944,0,1706
2017,Octubre,Rumania,88,91,0,179
2017,Octubre,Rwanda,1,1,0,2
2017,Octubre,San Cristóbal y Nevis,0,10,0,10
2017,Octubre,Samoa Occidental,0,1,0,1
2017,Octubre,San Marino,0,2,0,2
2017,Octubre,San  Vicente y las Granadinas,1,4,0,5
2017,Octubre,Santa Lucia,6,4,0,10
2017,Octubre,Santa Sede/Ciudad del Vaticano,0,1,0,1
2017,Octubre,Santo Tomé y Príncipe,0,1,0,1
2017,Octubre,Senegal,1,2,0,3
2017,Octubre,Serbia,12,14,0,26
2017,Octubre,Seychelles,1,0,0,1
2017,Octubre,Sierra Leona,2,1,0,3
2017,Octubre,Singapur,34,67,0,101
2017,Octubre,República Árabe Siria,4,5,0,9
2017,Octubre,Somalia,0,2,0,2
2017,Octubre,Sri Lanka,1,16,0,17
2017,Octubre,Sudáfrica,60,85,0,145
2017,Octubre,Sudán,1,2,0,3
2017,Octubre,Suecia,274,385,0,659
2017,Octubre,Suiza,564,873,0,1437
2017,Octubre,Surinam,15,22,0,37
2017,Octubre,Suazilandia,1,0,0,1
2017,Octubre,Taiwán,49,98,0,147
2017,Octubre,República de Tayikistán,1,0,0,1
2017,Octubre,Tailandia,43,39,0,82
2017,Octubre,Tanzania,4,7,0,11
2017,Octubre,República Democrática de Timor Oriental,0,1,0,1
2017,Octubre,Togo,0,1,0,1
2017,Octubre,Tonga,1,0,0,1
2017,Octubre,Trinidad y Tobago,38,102,0,140
2017,Octubre,Túnez,6,7,0,13
2017,Octubre,Turkmenistán,1,0,0,1
2017,Octubre,Turquía,192,394,0,586
2017,Octubre,Ucrania,38,48,0,86
2017,Octubre,Uganda,3,9,0,12
2017,Octubre,Uruguay,651,988,0,1639
2017,Octubre,Uzbekistán,2,1,0,3
2017,Octubre,Vanuatu,0,1,0,1
2017,Octubre,Venezuela,38819,45693,0,84512
2017,Octubre,Vietnam,4,10,0,14
2017,Octubre,República Árabe de Yemen,1,1,0,2
2017,Octubre,Zambia,2,5,0,7
2017,Octubre,Zimbabue,2,6,0,8
2017,Octubre,Anguila/Territorio Británico de Ultramar,0,1,0,1
2017,Octubre,Refugiado,0,5,0,5
2017,Octubre,Desconocido,101,199,0,300
2017,Noviembre,Afganistán,0,1,0,1
2017,Noviembre,Albania,3,7,0,10
2017,Noviembre,Alemania,2153,3412,0,5565
2017,Noviembre,Andorra,2,10,0,12
2017,Noviembre,Angola,0,2,0,2
2017,Noviembre,Antigua y Barbuda,3,6,0,9
2017,Noviembre,Países Bajos,1844,2599,0,4443
2017,Noviembre,Arabia Saudita,0,8,0,8
2017,Noviembre,Argelia,2,3,0,5
2017,Noviembre,Argentina,6551,8049,0,14600
2017,Noviembre,República de Armenia,1,2,0,3
2017,Noviembre,Aruba,0,1,0,1
2017,Noviembre,Australia,631,983,0,1614
2017,Noviembre,Austria,229,404,0,633
2017,Noviembre,Azerbaiyán,1,3,0,4
2017,Noviembre,Bahamas,12,19,0,31
2017,Noviembre,Bahréin,1,1,0,2
2017,Noviembre,Bangladesh,1,2,0,3
2017,Noviembre,Barbados,17,18,0,35
2017,Noviembre,República de Belarús,8,15,0,23
2017,Noviembre,Bélgica,361,676,0,1037
2017,Noviembre,Belice,13,36,0,49
2017,Noviembre,Bermudas/Territorio Británico de Ultramar,1,5,0,6
2017,Noviembre,Bolivia,1207,1327,0,2534
2017,Noviembre,Bosnia y Herzegovina,1,5,0,6
2017,Noviembre,Brasil,10088,10830,0,20918
2017,Noviembre,Bulgaria,41,46,0,87
2017,Noviembre,Burkina Faso,2,0,0,2
2017,Noviembre,Bután,2,0,0,2
2017,Noviembre,Cabo Verde,0,2,0,2
2017,Noviembre,Islas Caimán/Territorio Británico de Ultramar,5,4,0,9
2017,Noviembre,Camboya,0,3,0,3
2017,Noviembre,Camerún,2,1,0,3
2017,Noviembre,Canadá,1520,2736,0,4256
2017,Noviembre,España,4060,8363,0,12423
2017,Noviembre,República Democrática del Congo,4,3,0,7
2017,Noviembre,República de Corea,268,612,0,880
2017,Noviembre,Costa de Marfil,1,1,0,2
2017,Noviembre,Costa Rica,1369,1994,0,3363
2017,Noviembre,Croacia,25,90,0,115
2017,Noviembre,Cuba,310,618,0,928
2017,Noviembre,República Checa,97,169,0,266
2017,Noviembre,Chile,5351,6287,0,11638
2017,Noviembre,China,491,1102,0,1593
2017,Noviembre,Chipre,2,5,0,7
2017,Noviembre,Dinamarca,143,265,0,408
2017,Noviembre,Dominica,4,8,0,12
2017,Noviembre,Ecuador,6868,9355,0,16223
2017,Noviembre,Egipto,7,23,0,30
2017,Noviembre,El Salvador,1136,1551,0,2687
2017,Noviembre,Emiratos Árabes,5,23,0,28
2017,Noviembre,Eslovaquia,46,63,0,109
2017,Noviembre,Eslovenia,36,65,0,101
2017,Noviembre,Estados Unidos de América,15004,27490,0,42494
2017,Noviembre,Estonia,9,21,0,30
2017,Noviembre,Etiopia,1,4,0,5
2017,Noviembre,Filipinas,48,242,0,290
2017,Noviembre,Finlandia,78,116,0,194
2017,Noviembre,Francia,2141,3536,0,5677
2017,Noviembre,Georgia,5,3,0,8
2017,Noviembre,Ghana,1,4,0,5
2017,Noviembre,Gibraltar/Territorio Británico de Ultramar,0,1,0,1
2017,Noviembre,Granada,3,12,0,15
2017,Noviembre,Grecia,42,97,0,139
2017,Noviembre,Guatemala,951,1461,0,2412
2017,Noviembre,Guyana,7,24,0,31
2017,Noviembre,Guinea,0,3,0,3
2017,Noviembre,Guinea Ecuatorial,1,1,0,2
2017,Noviembre,Guinea Bissau,1,1,0,2
2017,Noviembre,Haití,8,26,0,34
2017,Noviembre,Honduras,301,410,0,711
2017,Noviembre,Hong Kong,3,7,0,10
2017,Noviembre,Hungría,51,62,0,113
2017,Noviembre,India,125,565,0,690
2017,Noviembre,Indonesia,21,59,0,80
2017,Noviembre,Iraq,0,1,0,1
2017,Noviembre,Irán,6,18,0,24
2017,Noviembre,República de Irlanda,179,317,0,496
2017,Noviembre,Islandia,6,21,0,27
2017,Noviembre,Israel,135,547,0,682
2017,Noviembre,Italia,989,2929,0,3918
2017,Noviembre,Jamaica,36,56,0,92
2017,Noviembre,Japón,164,657,0,821
2017,Noviembre,Jordania,6,13,0,19
2017,Noviembre,Kazajistán,15,28,0,43
2017,Noviembre,Kenia,11,13,0,24
2017,Noviembre,Kiribati,0,1,0,1
2017,Noviembre,Kirguistán,1,1,0,2
2017,Noviembre,Lesoto,1,0,0,1
2017,Noviembre,Letonia,31,27,0,58
2017,Noviembre,Lituania,25,41,0,66
2017,Noviembre,Líbano,22,36,0,58
2017,Noviembre,Libia,1,1,0,2
2017,Noviembre,Liechtenstein,2,3,0,5
2017,Noviembre,Luxemburgo,9,7,0,16
2017,Noviembre,Macedonia,1,4,0,5
2017,Noviembre,Madagascar,1,0,0,1
2017,Noviembre,Malasia,25,33,0,58
2017,Noviembre,Malawi,2,1,0,3
2017,Noviembre,Malí,0,1,0,1
2017,Noviembre,Malta,9,11,0,20
2017,Noviembre,Marruecos,5,22,0,27
2017,Noviembre,Mauricio,2,5,0,7
2017,Noviembre,México,5677,10306,0,15983
2017,Noviembre,República de Moldavia,4,1,0,5
2017,Noviembre,Mónaco,0,2,0,2
2017,Noviembre,Mongolia,1,3,0,4
2017,Noviembre,Montenegro,0,11,0,11
2017,Noviembre,Mozambique,1,5,0,6
2017,Noviembre,Myanmar,0,1,0,1
2017,Noviembre,Namibia,0,1,0,1
2017,Noviembre,Nepal,3,4,0,7
2017,Noviembre,Nicaragua,158,199,0,357
2017,Noviembre,Nigeria,2,9,0,11
2017,Noviembre,Noruega,166,219,0,385
2017,Noviembre,Nueva Zelanda,102,190,0,292
2017,Noviembre,Omán,0,3,0,3
2017,Noviembre,Pakistán,5,21,0,26
2017,Noviembre,Panamá,7032,6113,0,13145
2017,Noviembre,Paraguay,483,493,0,976
2017,Noviembre,Perú,5555,7230,0,12785
2017,Noviembre,Palestina,1,1,0,2
2017,Noviembre,Polonia,298,416,0,714
2017,Noviembre,Portugal,372,654,0,1026
2017,Noviembre,Qatar,0,2,0,2
2017,Noviembre,Reino Unido de Gran Bretaña e Irlanda del Norte,1324,2711,0,4035
2017,Noviembre,Federación de Rusia,186,299,0,485
2017,Noviembre,República Dominicana,926,1230,0,2156
2017,Noviembre,Rumania,64,102,0,166
2017,Noviembre,San Cristóbal y Nevis,6,12,0,18
2017,Noviembre,San  Vicente y las Granadinas,2,10,0,12
2017,Noviembre,Santa Lucia,10,9,0,19
2017,Noviembre,Santa Sede/Ciudad del Vaticano,0,2,0,2
2017,Noviembre,Santo Tomé y Príncipe,0,2,0,2
2017,Noviembre,Senegal,1,4,0,5
2017,Noviembre,Serbia,7,27,0,34
2017,Noviembre,Singapur,22,37,0,59
2017,Noviembre,República Árabe Siria,2,1,0,3
2017,Noviembre,Somalia,0,1,0,1
2017,Noviembre,Sri Lanka,2,8,0,10
2017,Noviembre,Sudáfrica,32,58,0,90
2017,Noviembre,Suecia,296,434,0,730
2017,Noviembre,Suiza,641,1035,0,1676
2017,Noviembre,Surinam,14,23,0,37
2017,Noviembre,Taiwán,130,117,0,247
2017,Noviembre,República de Tayikistán,4,6,0,10
2017,Noviembre,Tailandia,35,25,0,60
2017,Noviembre,Tanzania,1,1,0,2
2017,Noviembre,Togo,0,2,0,2
2017,Noviembre,Trinidad y Tobago,36,85,0,121
2017,Noviembre,Túnez,4,5,0,9
2017,Noviembre,Turkmenistán,1,0,0,1
2017,Noviembre,Turquía,173,319,0,492
2017,Noviembre,Ucrania,37,71,0,108
2017,Noviembre,Uganda,3,4,0,7
2017,Noviembre,Uruguay,558,794,0,1352
2017,Noviembre,Uzbekistán,0,1,0,1
2017,Noviembre,Venezuela,43850,52056,0,95906
2017,Noviembre,Vietnam,8,4,0,12
2017,Noviembre,Islas Vírgenes Británicas/Territorio Británico de Ultramar,3,2,0,5
2017,Noviembre,República Árabe de Yemen,0,3,0,3
2017,Noviembre,Zimbabue,2,1,0,3
2017,Noviembre,Refugiado,0,1,0,1
2017,Noviembre,Desconocido,107,203,0,310
2017,Diciembre,Albania,3,9,0,12
2017,Diciembre,Alemania,2827,4133,0,6960
2017,Diciembre,Andorra,3,8,0,11
2017,Diciembre,Angola,3,2,0,5
2017,Diciembre,Antigua y Barbuda,1,2,0,3
2017,Diciembre,Países Bajos,1999,2970,0,4969
2017,Diciembre,Arabia Saudita,1,24,0,25
2017,Diciembre,Argelia,2,10,0,12
2017,Diciembre,Argentina,7890,9248,0,17138
2017,Diciembre,República de Armenia,2,0,0,2
2017,Diciembre,Australia,782,1323,0,2105
2017,Diciembre,Austria,270,449,0,719
2017,Diciembre,Azerbaiyán,3,2,0,5
2017,Diciembre,Bahamas,12,18,0,30
2017,Diciembre,Bahréin,0,1,0,1
2017,Diciembre,Bangladesh,5,3,0,8
2017,Diciembre,Barbados,13,11,0,24
2017,Diciembre,República de Belarús,10,7,0,17
2017,Diciembre,Bélgica,408,729,0,1137
2017,Diciembre,Belice,6,8,0,14
2017,Diciembre,Benín,0,1,0,1
2017,Diciembre,Bermudas/Territorio Británico de Ultramar,2,2,0,4
2017,Diciembre,Bolivia,1393,1192,0,2585
2017,Diciembre,Bosnia y Herzegovina,3,2,0,5
2017,Diciembre,Brasil,9921,9407,0,19328
2017,Diciembre,Brunei Darussalam,1,0,0,1
2017,Diciembre,Bulgaria,42,42,0,84
2017,Diciembre,Burundi,0,2,0,2
2017,Diciembre,Bután,1,0,0,1
2017,Diciembre,Cabo Verde,0,2,0,2
2017,Diciembre,Islas Caimán/Territorio Británico de Ultramar,15,9,0,24
2017,Diciembre,Camboya,2,1,0,3
2017,Diciembre,Camerún,1,3,0,4
2017,Diciembre,Canadá,3047,4457,0,7504
2017,Diciembre,España,4882,8107,0,12989
2017,Diciembre,República Del Congo,2,1,0,3
2017,Diciembre,República Democrática del Congo,4,2,0,6
2017,Diciembre,República de Corea,400,538,0,938
2017,Diciembre,Costa de Marfil,0,1,0,1
2017,Diciembre,Costa Rica,2351,2494,0,4845
2017,Diciembre,Croacia,32,80,0,112
2017,Diciembre,Cuba,362,657,0,1019
2017,Diciembre,República Checa,87,114,0,201
2017,Diciembre,Chile,4231,5332,0,9563
2017,Diciembre,China,392,791,0,1183
2017,Diciembre,Chipre,5,13,0,18
2017,Diciembre,Dinamarca,212,380,0,592
2017,Diciembre,Dominica,0,4,0,4
2017,Diciembre,Ecuador,6905,8801,0,15706
2017,Diciembre,Egipto,4,17,0,21
2017,Diciembre,El Salvador,1019,1229,0,2248
2017,Diciembre,Emiratos Árabes,2,17,0,19
2017,Diciembre,Eslovaquia,44,57,0,101
2017,Diciembre,Eslovenia,23,41,0,64
2017,Diciembre,Estados Unidos de América,23272,36358,0,59630
2017,Diciembre,Estonia,12,25,0,37
2017,Diciembre,Etiopia,2,0,0,2
2017,Diciembre,Islas Fiji,0,1,0,1
2017,Diciembre,Filipinas,62,208,0,270
2017,Diciembre,Finlandia,130,163,0,293
2017,Diciembre,Francia,2948,4549,0,7497
2017,Diciembre,Gabón,0,1,0,1
2017,Diciembre,Georgia,1,3,0,4
2017,Diciembre,Ghana,0,5,0,5
2017,Diciembre,Granada,5,9,0,14
2017,Diciembre,Grecia,54,119,0,173
2017,Diciembre,Guatemala,1141,1345,0,2486
2017,Diciembre,Guyana,7,13,0,20
2017,Diciembre,Haití,23,27,0,50
2017,Diciembre,Honduras,369,404,0,773
2017,Diciembre,Hong Kong,9,8,0,17
2017,Diciembre,Hungría,47,87,0,134
2017,Diciembre,India,135,503,0,638
2017,Diciembre,Indonesia,16,28,0,44
2017,Diciembre,Iraq,0,2,0,2
2017,Diciembre,Irán,10,17,0,27
2017,Diciembre,República de Irlanda,154,299,0,453
2017,Diciembre,Islandia,23,26,0,49
2017,Diciembre,Israel,181,616,0,797
2017,Diciembre,Italia,1361,2983,0,4344
2017,Diciembre,Jamaica,26,50,0,76
2017,Diciembre,Japón,308,574,0,882
2017,Diciembre,Jordania,1,12,0,13
2017,Diciembre,Kazajistán,11,7,0,18
2017,Diciembre,Kenia,5,7,0,12
2017,Diciembre,Kuwait,2,5,0,7
2017,Diciembre,República de Kosovo,0,3,0,3
2017,Diciembre,República Democrática Popular  Lao,1,0,0,1
2017,Diciembre,Letonia,12,16,0,28
2017,Diciembre,Lituania,32,33,0,65
2017,Diciembre,Líbano,21,57,0,78
2017,Diciembre,Libia,0,1,0,1
2017,Diciembre,Liechtenstein,8,3,0,11
2017,Diciembre,Luxemburgo,10,26,0,36
2017,Diciembre,Macedonia,3,5,0,8
2017,Diciembre,Madagascar,2,0,0,2
2017,Diciembre,Malasia,31,24,0,55
2017,Diciembre,Maldivas,0,1,0,1
2017,Diciembre,Malí,0,1,0,1
2017,Diciembre,Malta,7,23,0,30
2017,Diciembre,Marruecos,15,23,0,38
2017,Diciembre,Mauricio,1,2,0,3
2017,Diciembre,Mauritania,0,1,0,1
2017,Diciembre,México,5741,8527,0,14268
2017,Diciembre,República de Moldavia,7,1,0,8
2017,Diciembre,Mónaco,0,1,0,1
2017,Diciembre,Mongolia,1,1,0,2
2017,Diciembre,Montenegro,4,9,0,13
2017,Diciembre,Mozambique,1,3,0,4
2017,Diciembre,Myanmar,2,5,0,7
2017,Diciembre,Namibia,1,1,0,2
2017,Diciembre,Nepal,2,4,0,6
2017,Diciembre,Nicaragua,176,162,0,338
2017,Diciembre,Nigeria,3,5,0,8
2017,Diciembre,Noruega,220,375,0,595
2017,Diciembre,Nueva Zelanda,115,213,0,328
2017,Diciembre,Omán,0,1,0,1
2017,Diciembre,Papúa Nueva Guinea,3,3,0,6
2017,Diciembre,Pakistán,10,20,0,30
2017,Diciembre,Panamá,4157,4722,0,8879
2017,Diciembre,Paraguay,297,215,0,512
2017,Diciembre,Perú,5219,6184,0,11403
2017,Diciembre,Palestina,2,0,0,2
2017,Diciembre,Polonia,207,203,0,410
2017,Diciembre,Portugal,309,606,0,915
2017,Diciembre,Qatar,0,1,0,1
2017,Diciembre,Reino Unido de Gran Bretaña e Irlanda del Norte,1855,3339,0,5194
2017,Diciembre,República CentroÁfricana,0,1,0,1
2017,Diciembre,Federación de Rusia,250,324,0,574
2017,Diciembre,República Dominicana,662,805,0,1467
2017,Diciembre,Rumania,111,123,0,234
2017,Diciembre,Rwanda,1,0,0,1
2017,Diciembre,San Cristóbal y Nevis,3,8,0,11
2017,Diciembre,San Marino,0,1,0,1
2017,Diciembre,San  Vicente y las Granadinas,0,4,0,4
2017,Diciembre,Santa Lucia,4,4,0,8
2017,Diciembre,Senegal,1,2,0,3
2017,Diciembre,Serbia,14,22,0,36
2017,Diciembre,Singapur,31,41,0,72
2017,Diciembre,República Árabe Siria,2,7,0,9
2017,Diciembre,Sri Lanka,4,4,0,8
2017,Diciembre,Sudáfrica,53,67,0,120
2017,Diciembre,Suecia,535,738,0,1273
2017,Diciembre,Suiza,893,1542,0,2435
2017,Diciembre,Surinam,3,16,0,19
2017,Diciembre,Taiwán,91,81,0,172
2017,Diciembre,República de Tayikistán,1,0,0,1
2017,Diciembre,Tailandia,26,14,0,40
2017,Diciembre,Tanzania,2,1,0,3
2017,Diciembre,Tonga,1,0,0,1
2017,Diciembre,Trinidad y Tobago,52,83,0,135
2017,Diciembre,Túnez,4,17,0,21
2017,Diciembre,Turkmenistán,1,0,0,1
2017,Diciembre,Turquía,178,350,0,528
2017,Diciembre,Ucrania,54,87,0,141
2017,Diciembre,Uganda,4,2,0,6
2017,Diciembre,Uruguay,465,637,0,1102
2017,Diciembre,Uzbekistán,1,0,0,1
2017,Diciembre,Venezuela,53226,56423,0,109649
2017,Diciembre,Vietnam,14,4,0,18
2017,Diciembre,Islas Vírgenes Británicas/Territorio Británico de Ultramar,1,0,0,1
2017,Diciembre,República Árabe de Yemen,0,3,0,3
2017,Diciembre,Zambia,1,4,0,5
2017,Diciembre,Zimbabue,1,9,0,10
2017,Diciembre,Refugiado,1,12,0,13
2017,Diciembre,Desconocido,57,129,0,186
2018,Enero,Afganistán,1,1,0,2
2018,Enero,Albania,2,11,0,13
2018,Enero,Alemania,2643,3780,0,6423
2018,Enero,Andorra,3,12,0,15
2018,Enero,Angola,0,2,0,2
2018,Enero,Antigua y Barbuda,1,1,0,2
2018,Enero,Países Bajos,1863,2491,0,4354
2018,Enero,Arabia Saudita,0,16,0,16
2018,Enero,Argelia,5,9,0,14
2018,Enero,Argentina,14258,12730,0,26988
2018,Enero,República de Armenia,2,2,0,4
2018,Enero,Aruba,1,0,0,1
2018,Enero,Australia,636,1109,0,1745
2018,Enero,Austria,307,477,0,784
2018,Enero,Azerbaiyán,3,5,0,8
2018,Enero,Bahamas,8,21,0,29
2018,Enero,Bahréin,1,0,0,1
2018,Enero,Bangladesh,0,4,0,4
2018,Enero,Barbados,7,18,0,25
2018,Enero,República de Belarús,6,6,0,12
2018,Enero,Bélgica,413,687,0,1100
2018,Enero,Belice,7,13,0,20
2018,Enero,Bermudas/Territorio Británico de Ultramar,0,1,0,1
2018,Enero,Bolivia,1259,1141,0,2400
2018,Enero,Bosnia y Herzegovina,3,3,0,6
2018,Enero,Brasil,10983,10505,0,21488
2018,Enero,Bulgaria,54,76,0,130
2018,Enero,Bután,1,0,0,1
2018,Enero,Cabo Verde,0,5,0,5
2018,Enero,Islas Caimán/Territorio Británico de Ultramar,0,3,0,3
2018,Enero,Camerún,0,2,0,2
2018,Enero,Canadá,3031,4253,0,7284
2018,Enero,España,3970,7421,0,11391
2018,Enero,República Democrática del Congo,3,6,0,9
2018,Enero,República de Corea,537,708,0,1245
2018,Enero,Costa de Marfil,1,3,0,4
2018,Enero,Costa Rica,2453,2296,0,4749
2018,Enero,Croacia,48,95,0,143
2018,Enero,Cuba,978,1051,0,2029
2018,Enero,República Checa,112,154,0,266
2018,Enero,Chile,5066,5597,0,10663
2018,Enero,China,492,864,0,1356
2018,Enero,Chipre,9,8,0,17
2018,Enero,Dinamarca,260,370,0,630
2018,Enero,Dominica,7,8,0,15
2018,Enero,Ecuador,4899,7198,0,12097
2018,Enero,Egipto,6,32,0,38
2018,Enero,El Salvador,946,1188,0,2134
2018,Enero,Emiratos Árabes,1,14,0,15
2018,Enero,Eslovaquia,63,87,0,150
2018,Enero,Eslovenia,47,67,0,114
2018,Enero,Estados Unidos de América,15255,26503,0,41758
2018,Enero,Estonia,21,39,0,60
2018,Enero,Etiopia,1,5,0,6
2018,Enero,Filipinas,74,223,0,297
2018,Enero,Finlandia,116,107,0,223
2018,Enero,Francia,3565,4923,0,8488
2018,Enero,Georgia,3,4,0,7
2018,Enero,Ghana,2,16,0,18
2018,Enero,Granada,1,2,0,3
2018,Enero,Grecia,40,90,0,130
2018,Enero,Guatemala,615,973,0,1588
2018,Enero,Guyana,7,14,0,21
2018,Enero,Haití,10,26,0,36
2018,Enero,Honduras,343,430,0,773
2018,Enero,Hong Kong,8,9,0,17
2018,Enero,Hungría,84,132,0,216
2018,Enero,India,123,566,0,689
2018,Enero,Indonesia,18,40,0,58
2018,Enero,Iraq,0,2,0,2
2018,Enero,Irán,10,15,0,25
2018,Enero,República de Irlanda,178,330,0,508
2018,Enero,Islandia,17,15,0,32
2018,Enero,Israel,219,753,0,972
2018,Enero,Italia,1277,3077,0,4354
2018,Enero,Jamaica,43,49,0,92
2018,Enero,Japón,252,568,0,820
2018,Enero,Jordania,2,6,0,8
2018,Enero,Kazajistán,5,8,0,13
2018,Enero,Kenia,7,11,0,18
2018,Enero,Kirguistán,2,1,0,3
2018,Enero,Kuwait,0,7,0,7
2018,Enero,República de Kosovo,0,1,0,1
2018,Enero,República Democrática Popular  Lao,1,0,0,1
2018,Enero,Letonia,22,30,0,52
2018,Enero,Lituania,24,48,0,72
2018,Enero,Líbano,13,27,0,40
2018,Enero,Liberia,1,0,0,1
2018,Enero,Libia,0,2,0,2
2018,Enero,Liechtenstein,3,3,0,6
2018,Enero,Luxemburgo,17,18,0,35
2018,Enero,Macedonia,0,2,0,2
2018,Enero,Madagascar,2,1,0,3
2018,Enero,Malasia,17,26,0,43
2018,Enero,Malawi,0,1,0,1
2018,Enero,Malí,0,2,0,2
2018,Enero,Malta,7,14,0,21
2018,Enero,Marruecos,15,19,0,34
2018,Enero,Mauricio,1,3,0,4
2018,Enero,México,4681,7903,0,12584
2018,Enero,República de Moldavia,6,0,0,6
2018,Enero,Mónaco,1,4,0,5
2018,Enero,Mongolia,4,2,0,6
2018,Enero,Montenegro,5,5,0,10
2018,Enero,Mozambique,1,4,0,5
2018,Enero,Myanmar,0,4,0,4
2018,Enero,Nepal,2,2,0,4
2018,Enero,Nicaragua,180,163,0,343
2018,Enero,Nigeria,6,9,0,15
2018,Enero,Níger,0,1,0,1
2018,Enero,Noruega,269,307,0,576
2018,Enero,Nueva Zelanda,130,183,0,313
2018,Enero,Omán,0,1,0,1
2018,Enero,Papúa Nueva Guinea,0,1,0,1
2018,Enero,Pakistán,5,23,0,28
2018,Enero,Panamá,5172,4181,0,9353
2018,Enero,Paraguay,480,345,0,825
2018,Enero,Perú,5351,6446,0,11797
2018,Enero,Palestina,2,2,0,4
2018,Enero,Polonia,277,381,0,658
2018,Enero,Portugal,375,742,0,1117
2018,Enero,Puerto Rico/Territorio de Estados Unidos,1,0,0,1
2018,Enero,Reino Unido de Gran Bretaña e Irlanda del Norte,1654,2858,0,4512
2018,Enero,Federación de Rusia,335,374,0,709
2018,Enero,República Dominicana,694,839,0,1533
2018,Enero,Rumania,111,125,0,236
2018,Enero,Rwanda,0,1,0,1
2018,Enero,San Cristóbal y Nevis,4,5,0,9
2018,Enero,San Marino,1,1,0,2
2018,Enero,San  Vicente y las Granadinas,3,5,0,8
2018,Enero,Santa Lucia,4,4,0,8
2018,Enero,Santa Sede/Ciudad del Vaticano,0,1,0,1
2018,Enero,Senegal,0,2,0,2
2018,Enero,Serbia,9,31,0,40
2018,Enero,Singapur,32,41,0,73
2018,Enero,República Árabe Siria,1,2,0,3
2018,Enero,Sri Lanka,2,13,0,15
2018,Enero,Sudáfrica,36,55,0,91
2018,Enero,Suecia,496,643,0,1139
2018,Enero,Suiza,813,1174,0,1987
2018,Enero,Surinam,8,31,0,39
2018,Enero,Taiwán,66,96,0,162
2018,Enero,Tailandia,22,20,0,42
2018,Enero,Tanzania,1,0,0,1
2018,Enero,Togo,0,1,0,1
2018,Enero,Trinidad y Tobago,35,60,0,95
2018,Enero,Túnez,22,22,0,44
2018,Enero,Turquía,206,442,0,648
2018,Enero,Ucrania,50,56,0,106
2018,Enero,Uganda,1,2,0,3
2018,Enero,Uruguay,653,733,0,1386
2018,Enero,Uzbekistán,2,0,0,2
2018,Enero,Venezuela,54516,72457,0,126973
2018,Enero,Vietnam,4,9,0,13
2018,Enero,República Árabe de Yemen,0,1,0,1
2018,Enero,Zimbabue,0,3,0,3
2018,Enero,Islas Turcas y Caicos/Territorio Británico de Ultramar,0,1,0,1
2018,Enero,Refugiado Otro,0,1,0,1
2018,Enero,Refugiado,5,5,0,10
2018,Enero,Desconocido,59,122,0,181
2018,Febrero,Albania,1,2,0,3
2018,Febrero,Alemania,3081,4160,0,7241
2018,Febrero,Andorra,4,13,0,17
2018,Febrero,Angola,4,3,0,7
2018,Febrero,Antigua y Barbuda,2,1,0,3
2018,Febrero,Países Bajos,1874,2571,0,4445
2018,Febrero,Arabia Saudita,0,8,0,8
2018,Febrero,Argelia,1,6,0,7
2018,Febrero,Argentina,10923,11137,0,22060
2018,Febrero,República de Armenia,2,1,0,3
2018,Febrero,Australia,436,774,0,1210
2018,Febrero,Austria,395,481,0,876
2018,Febrero,Azerbaiyán,2,6,0,8
2018,Febrero,Bahamas,11,28,0,39
2018,Febrero,Bahréin,0,2,0,2
2018,Febrero,Bangladesh,1,0,0,1
2018,Febrero,Barbados,8,11,0,19
2018,Febrero,República de Belarús,6,6,0,12
2018,Febrero,Bélgica,368,598,0,966
2018,Febrero,Belice,2,14,0,16
2018,Febrero,Bermudas/Territorio Británico de Ultramar,2,1,0,3
2018,Febrero,Bolivia,857,792,0,1649
2018,Febrero,Bosnia y Herzegovina,0,7,0,7
2018,Febrero,Botsuana,1,1,0,2
2018,Febrero,Brasil,9359,9363,0,18722
2018,Febrero,Bulgaria,55,56,0,111
2018,Febrero,Burkina Faso,1,6,0,7
2018,Febrero,Bután,0,1,0,1
2018,Febrero,Islas Caimán/Territorio Británico de Ultramar,2,4,0,6
2018,Febrero,Camerún,1,6,0,7
2018,Febrero,Canadá,3063,4331,0,7394
2018,Febrero,Chad,1,0,0,1
2018,Febrero,España,3646,7073,0,10719
2018,Febrero,República Democrática del Congo,0,5,0,5
2018,Febrero,República de Corea,289,458,0,747
2018,Febrero,Costa de Marfil,0,4,0,4
2018,Febrero,Costa Rica,1400,1726,0,3126
2018,Febrero,Croacia,25,80,0,105
2018,Febrero,Cuba,1105,873,0,1978
2018,Febrero,República Checa,110,168,0,278
2018,Febrero,Chile,8195,7770,0,15965
2018,Febrero,China,506,694,0,1200
2018,Febrero,Chipre,14,13,0,27
2018,Febrero,Dinamarca,243,347,0,590
2018,Febrero,Dominica,3,10,0,13
2018,Febrero,Ecuador,5446,7382,0,12828
2018,Febrero,Egipto,2,41,0,43
2018,Febrero,El Salvador,1041,1227,0,2268
2018,Febrero,Emiratos Árabes,3,12,0,15
2018,Febrero,Eritrea,1,0,0,1
2018,Febrero,Eslovaquia,53,102,0,155
2018,Febrero,Eslovenia,31,45,0,76
2018,Febrero,Estados Unidos de América,18798,31298,0,50096
2018,Febrero,Estonia,22,18,0,40
2018,Febrero,Etiopia,2,6,0,8
2018,Febrero,Islas Fiji,0,2,0,2
2018,Febrero,Filipinas,57,230,0,287
2018,Febrero,Finlandia,106,129,0,235
2018,Febrero,Francia,3746,4852,0,8598
2018,Febrero,Georgia,1,12,0,13
2018,Febrero,Ghana,6,15,0,21
2018,Febrero,Granada,1,4,0,5
2018,Febrero,Grecia,47,121,0,168
2018,Febrero,Guatemala,968,1353,0,2321
2018,Febrero,Guyana,11,13,0,24
2018,Febrero,Haití,32,44,0,76
2018,Febrero,Honduras,483,505,0,988
2018,Febrero,Hong Kong,10,15,0,25
2018,Febrero,Hungría,49,92,0,141
2018,Febrero,India,99,498,0,597
2018,Febrero,Indonesia,25,59,0,84
2018,Febrero,Iraq,0,2,0,2
2018,Febrero,Irán,2,16,0,18
2018,Febrero,República de Irlanda,137,283,0,420
2018,Febrero,Islandia,22,36,0,58
2018,Febrero,Israel,322,1010,0,1332
2018,Febrero,Islas Aland/Provincia de Finlandia,0,1,0,1
2018,Febrero,Italia,1234,2764,0,3998
2018,Febrero,Jamaica,52,60,0,112
2018,Febrero,Islas Salomón,0,1,0,1
2018,Febrero,Japón,271,684,0,955
2018,Febrero,Jordania,1,10,0,11
2018,Febrero,Kazajistán,9,5,0,14
2018,Febrero,Kenia,10,10,0,20
2018,Febrero,Kiribati,0,5,0,5
2018,Febrero,Kirguistán,1,1,0,2
2018,Febrero,Kuwait,0,6,0,6
2018,Febrero,República de Kosovo,0,2,0,2
2018,Febrero,Letonia,15,25,0,40
2018,Febrero,Lituania,55,48,0,103
2018,Febrero,Líbano,24,31,0,55
2018,Febrero,Liechtenstein,1,1,0,2
2018,Febrero,Luxemburgo,12,22,0,34
2018,Febrero,Macedonia,0,4,0,4
2018,Febrero,Madagascar,1,0,0,1
2018,Febrero,Malasia,27,22,0,49
2018,Febrero,Malawi,3,1,0,4
2018,Febrero,Malí,0,1,0,1
2018,Febrero,Malta,8,17,0,25
2018,Febrero,Marruecos,13,19,0,32
2018,Febrero,Mauricio,0,2,0,2
2018,Febrero,México,4571,8685,0,13256
2018,Febrero,República de Moldavia,2,1,0,3
2018,Febrero,Mónaco,0,1,0,1
2018,Febrero,Mongolia,1,0,0,1
2018,Febrero,Montenegro,2,7,0,9
2018,Febrero,Mozambique,2,1,0,3
2018,Febrero,Myanmar,1,6,0,7
2018,Febrero,Namibia,0,1,0,1
2018,Febrero,Nepal,1,6,0,7
2018,Febrero,Nicaragua,159,154,0,313
2018,Febrero,Nigeria,7,14,0,21
2018,Febrero,Noruega,182,235,0,417
2018,Febrero,Nueva Zelanda,75,111,0,186
2018,Febrero,Pakistán,7,22,0,29
2018,Febrero,Panamá,6879,5818,0,12697
2018,Febrero,Paraguay,353,456,0,809
2018,Febrero,Perú,6132,6917,0,13049
2018,Febrero,Palestina,3,6,0,9
2018,Febrero,Polonia,286,342,0,628
2018,Febrero,Portugal,288,578,0,866
2018,Febrero,Puerto Rico/Territorio de Estados Unidos,2,0,0,2
2018,Febrero,Qatar,0,1,0,1
2018,Febrero,Reino Unido de Gran Bretaña e Irlanda del Norte,1558,2714,0,4272
2018,Febrero,Federación de Rusia,208,286,0,494
2018,Febrero,República Dominicana,771,1100,0,1871
2018,Febrero,Rumania,101,134,0,235
2018,Febrero,Rwanda,0,2,0,2
2018,Febrero,San Cristóbal y Nevis,3,3,0,6
2018,Febrero,Samoa Estadounidense/Territorio no incorporado de Estados Unidos,1,0,0,1
2018,Febrero,San Marino,0,2,0,2
2018,Febrero,San  Vicente y las Granadinas,0,2,0,2
2018,Febrero,Santa Lucia,0,6,0,6
2018,Febrero,Senegal,2,2,0,4
2018,Febrero,Serbia,15,26,0,41
2018,Febrero,Singapur,21,12,0,33
2018,Febrero,República Árabe Siria,1,9,0,10
2018,Febrero,Sri Lanka,4,11,0,15
2018,Febrero,Sudáfrica,18,43,0,61
2018,Febrero,Suecia,421,546,0,967
2018,Febrero,Suiza,817,1126,0,1943
2018,Febrero,Surinam,8,16,0,24
2018,Febrero,Taiwán,109,105,0,214
2018,Febrero,Tailandia,6,9,0,15
2018,Febrero,Tanzania,1,1,0,2
2018,Febrero,Tonga,0,1,0,1
2018,Febrero,Trinidad y Tobago,28,65,0,93
2018,Febrero,Túnez,0,12,0,12
2018,Febrero,Turquía,190,394,0,584
2018,Febrero,Ucrania,42,54,0,96
2018,Febrero,Uganda,3,1,0,4
2018,Febrero,Uruguay,596,785,0,1381
2018,Febrero,Uzbekistán,0,1,0,1
2018,Febrero,Venezuela,55554,73118,0,128672
2018,Febrero,Vietnam,4,4,0,8
2018,Febrero,Islas Vírgenes Británicas/Territorio Británico de Ultramar,1,1,0,2
2018,Febrero,República Árabe de Yemen,0,2,0,2
2018,Febrero,Zimbabue,1,2,0,3
2018,Febrero,Refugiado Otro,0,5,0,5
2018,Febrero,Refugiado,3,6,0,9
2018,Febrero,Desconocido,62,142,0,204
2018,Marzo,Afganistán,1,4,0,5
2018,Marzo,Albania,5,4,0,9
2018,Marzo,Alemania,3331,4502,2,7835
2018,Marzo,Andorra,2,8,0,10
2018,Marzo,Angola,3,1,0,4
2018,Marzo,Antigua y Barbuda,4,10,0,14
2018,Marzo,Países Bajos,2113,2710,0,4823
2018,Marzo,Arabia Saudita,1,10,0,11
2018,Marzo,Argelia,2,6,0,8
2018,Marzo,Argentina,13470,12891,1,26362
2018,Marzo,República de Armenia,1,1,0,2
2018,Marzo,Australia,451,818,0,1269
2018,Marzo,Austria,266,459,0,725
2018,Marzo,Azerbaiyán,5,6,0,11
2018,Marzo,Bahamas,9,24,0,33
2018,Marzo,Bahréin,1,4,0,5
2018,Marzo,Bangladesh,4,5,0,9
2018,Marzo,Barbados,6,9,0,15
2018,Marzo,República de Belarús,3,7,0,10
2018,Marzo,Bélgica,408,645,0,1053
2018,Marzo,Belice,16,26,0,42
2018,Marzo,Benín,2,3,0,5
2018,Marzo,Bermudas/Territorio Británico de Ultramar,3,8,0,11
2018,Marzo,Bolivia,711,783,2,1496
2018,Marzo,Bosnia y Herzegovina,5,6,0,11
2018,Marzo,Botsuana,1,0,0,1
2018,Marzo,Brasil,9196,8981,0,18177
2018,Marzo,Bulgaria,45,66,0,111
2018,Marzo,Burkina Faso,2,2,0,4
2018,Marzo,Burundi,1,0,0,1
2018,Marzo,Bután,0,2,0,2
2018,Marzo,Cabo Verde,0,1,0,1
2018,Marzo,Islas Caimán/Territorio Británico de Ultramar,2,3,0,5
2018,Marzo,Camboya,2,0,0,2
2018,Marzo,Camerún,4,6,0,10
2018,Marzo,Canadá,3242,4263,0,7505
2018,Marzo,Chad,0,3,0,3
2018,Marzo,España,4695,7780,0,12475
2018,Marzo,Comoras,0,1,0,1
2018,Marzo,República Democrática del Congo,2,5,0,7
2018,Marzo,República de Corea,300,526,0,826
2018,Marzo,Costa de Marfil,3,4,0,7
2018,Marzo,Costa Rica,1837,2130,0,3967
2018,Marzo,Croacia,39,75,0,114
2018,Marzo,Cuba,688,698,0,1386
2018,Marzo,República Checa,108,155,0,263
2018,Marzo,Chile,5005,6066,0,11071
2018,Marzo,China,567,1188,0,1755
2018,Marzo,Chipre,10,12,0,22
2018,Marzo,Dinamarca,246,413,0,659
2018,Marzo,Dominica,7,9,0,16
2018,Marzo,Ecuador,6771,8383,0,15154
2018,Marzo,Egipto,8,28,0,36
2018,Marzo,El Salvador,1236,1378,0,2614
2018,Marzo,Emiratos Árabes,2,20,0,22
2018,Marzo,Eritrea,1,1,0,2
2018,Marzo,Eslovaquia,46,76,0,122
2018,Marzo,Eslovenia,53,78,0,131
2018,Marzo,Estados Unidos de América,24215,34902,0,59117
2018,Marzo,Estonia,29,34,0,63
2018,Marzo,Etiopia,3,8,0,11
2018,Marzo,Islas Fiji,1,3,0,4
2018,Marzo,Filipinas,64,296,0,360
2018,Marzo,Finlandia,84,104,0,188
2018,Marzo,Francia,3206,4422,0,7628
2018,Marzo,Georgia,5,2,0,7
2018,Marzo,Ghana,11,15,0,26
2018,Marzo,Granada,3,7,0,10
2018,Marzo,Grecia,52,135,0,187
2018,Marzo,Guatemala,798,1241,0,2039
2018,Marzo,Guyana,11,20,0,31
2018,Marzo,Guinea,0,1,0,1
2018,Marzo,Guinea Bissau,0,2,0,2
2018,Marzo,Haití,15,29,0,44
2018,Marzo,Honduras,519,524,0,1043
2018,Marzo,Hong Kong,15,11,0,26
2018,Marzo,Hungría,75,89,0,164
2018,Marzo,India,157,579,1,737
2018,Marzo,Indonesia,21,56,0,77
2018,Marzo,Iraq,1,3,0,4
2018,Marzo,Irán,8,17,1,26
2018,Marzo,República de Irlanda,225,393,0,618
2018,Marzo,Islandia,16,18,0,34
2018,Marzo,Israel,608,1113,0,1721
2018,Marzo,Italia,1042,2459,0,3501
2018,Marzo,Jamaica,48,51,0,99
2018,Marzo,Japón,298,636,0,934
2018,Marzo,Jordania,4,7,0,11
2018,Marzo,Kazajistán,8,1,0,9
2018,Marzo,Kenia,13,18,0,31
2018,Marzo,Kirguistán,0,2,0,2
2018,Marzo,Kuwait,3,7,0,10
2018,Marzo,República de Kosovo,2,2,0,4
2018,Marzo,Lesoto,1,0,0,1
2018,Marzo,Letonia,19,39,0,58
2018,Marzo,Lituania,27,40,0,67
2018,Marzo,Líbano,24,36,0,60
2018,Marzo,Liberia,1,0,0,1
2018,Marzo,Liechtenstein,5,5,0,10
2018,Marzo,Luxemburgo,14,31,0,45
2018,Marzo,Macedonia,1,3,0,4
2018,Marzo,Madagascar,0,1,0,1
2018,Marzo,Malasia,31,34,0,65
2018,Marzo,Malawi,1,2,0,3
2018,Marzo,Maldivas,1,0,0,1
2018,Marzo,Malí,0,4,0,4
2018,Marzo,Malta,5,15,0,20
2018,Marzo,Marruecos,12,14,0,26
2018,Marzo,Mauricio,4,2,0,6
2018,Marzo,Mauritania,0,1,0,1
2018,Marzo,México,6320,10396,2,16718
2018,Marzo,República de Moldavia,6,3,0,9
2018,Marzo,Mónaco,1,7,0,8
2018,Marzo,Montenegro,2,7,0,9
2018,Marzo,Mozambique,2,0,0,2
2018,Marzo,Myanmar,1,23,0,24
2018,Marzo,Namibia,1,0,0,1
2018,Marzo,Nepal,2,8,0,10
2018,Marzo,Nicaragua,236,204,0,440
2018,Marzo,Nigeria,5,16,0,21
2018,Marzo,Noruega,224,246,0,470
2018,Marzo,Nueva Zelanda,106,177,0,283
2018,Marzo,Omán,1,2,0,3
2018,Marzo,Papúa Nueva Guinea,0,2,0,2
2018,Marzo,Pakistán,12,25,0,37
2018,Marzo,Panamá,3641,3642,0,7283
2018,Marzo,Paraguay,388,327,0,715
2018,Marzo,Perú,5821,6844,0,12665
2018,Marzo,Palestina,1,4,0,5
2018,Marzo,Polonia,243,360,0,603
2018,Marzo,Portugal,395,656,0,1051
2018,Marzo,Puerto Rico/Territorio de Estados Unidos,0,1,0,1
2018,Marzo,Qatar,0,2,0,2
2018,Marzo,Reino Unido de Gran Bretaña e Irlanda del Norte,1856,3200,0,5056
2018,Marzo,Federación de Rusia,220,274,0,494
2018,Marzo,República Dominicana,1101,1148,0,2249
2018,Marzo,Rumania,99,134,0,233
2018,Marzo,Rwanda,0,1,0,1
2018,Marzo,San Cristóbal y Nevis,3,7,0,10
2018,Marzo,San Marino,1,3,0,4
2018,Marzo,San  Vicente y las Granadinas,2,1,0,3
2018,Marzo,Santa Lucia,3,12,0,15
2018,Marzo,Santa Sede/Ciudad del Vaticano,1,0,0,1
2018,Marzo,Senegal,2,7,0,9
2018,Marzo,Serbia,12,28,0,40
2018,Marzo,Sierra Leona,0,1,0,1
2018,Marzo,Singapur,36,43,0,79
2018,Marzo,República Árabe Siria,1,5,0,6
2018,Marzo,Sri Lanka,1,6,0,7
2018,Marzo,Sudáfrica,56,80,0,136
2018,Marzo,Sudán,2,1,0,3
2018,Marzo,Suecia,391,479,0,870
2018,Marzo,Suiza,770,1033,0,1803
2018,Marzo,Surinam,17,27,0,44
2018,Marzo,Suazilandia,2,0,0,2
2018,Marzo,Taiwán,152,161,0,313
2018,Marzo,Tailandia,25,28,0,53
2018,Marzo,Tanzania,5,4,0,9
2018,Marzo,Togo,1,2,0,3
2018,Marzo,Trinidad y Tobago,40,93,0,133
2018,Marzo,Túnez,4,8,0,12
2018,Marzo,Turquía,261,484,0,745
2018,Marzo,Ucrania,38,55,0,93
2018,Marzo,Uganda,2,2,0,4
2018,Marzo,Uruguay,766,913,22,1701
2018,Marzo,Uzbekistán,0,7,0,7
2018,Marzo,Vanuatu,1,0,0,1
2018,Marzo,Venezuela,53271,65184,0,118455
2018,Marzo,Vietnam,18,14,0,32
2018,Marzo,República Árabe de Yemen,1,4,0,5
2018,Marzo,Zambia,3,0,0,3
2018,Marzo,Zimbabue,1,4,0,5
2018,Marzo,Refugiado,3,12,0,15
2018,Marzo,Desconocido,94,149,0,243
2018,Abril,Afganistán,0,1,0,1
2018,Abril,Albania,3,3,0,6
2018,Abril,Alemania,2017,3127,0,5144
2018,Abril,Andorra,2,7,0,9
2018,Abril,Antigua y Barbuda,1,6,0,7
2018,Abril,Países Bajos,2041,2604,0,4645
2018,Abril,Arabia Saudita,1,6,0,7
2018,Abril,Argelia,1,5,0,6
2018,Abril,Argentina,10653,11046,1,21700
2018,Abril,República de Armenia,3,3,0,6
2018,Abril,Aruba,2,0,0,2
2018,Abril,Australia,467,721,0,1188
2018,Abril,Austria,193,296,0,489
2018,Abril,Azerbaiyán,2,2,0,4
2018,Abril,Bahamas,17,18,0,35
2018,Abril,Bahréin,0,1,0,1
2018,Abril,Bangladesh,0,5,0,5
2018,Abril,Barbados,14,19,0,33
2018,Abril,República de Belarús,3,7,0,10
2018,Abril,Bélgica,262,543,0,805
2018,Abril,Belice,8,21,0,29
2018,Abril,Bermudas/Territorio Británico de Ultramar,1,1,0,2
2018,Abril,Bolivia,742,840,0,1582
2018,Abril,Bosnia y Herzegovina,6,12,0,18
2018,Abril,Brasil,8418,9078,8,17504
2018,Abril,Bulgaria,69,74,0,143
2018,Abril,Burkina Faso,0,2,0,2
2018,Abril,Cabo Verde,2,10,0,12
2018,Abril,Islas Caimán/Territorio Británico de Ultramar,1,3,0,4
2018,Abril,Camerún,1,1,0,2
2018,Abril,Canadá,1712,2858,1,4571
2018,Abril,España,3995,7480,1,11476
2018,Abril,República Democrática del Congo,3,5,0,8
2018,Abril,República de Corea,268,509,0,777
2018,Abril,Costa de Marfil,3,0,0,3
2018,Abril,Costa Rica,2022,2481,0,4503
2018,Abril,Croacia,25,65,0,90
2018,Abril,Cuba,301,431,0,732
2018,Abril,Curazao,0,2,0,2
2018,Abril,República Checa,100,146,0,246
2018,Abril,Chile,5401,6640,1,12042
2018,Abril,China,492,1062,0,1554
2018,Abril,Chipre,2,5,0,7
2018,Abril,Dinamarca,161,243,0,404
2018,Abril,Dominica,3,7,0,10
2018,Abril,Ecuador,5276,7257,1,12534
2018,Abril,Egipto,4,14,0,18
2018,Abril,El Salvador,1025,1282,0,2307
2018,Abril,Emiratos Árabes,4,13,0,17
2018,Abril,Eslovaquia,73,97,0,170
2018,Abril,Eslovenia,39,73,0,112
2018,Abril,Estados Unidos de América,16711,29937,1,46649
2018,Abril,Estonia,12,16,0,28
2018,Abril,Etiopia,0,6,0,6
2018,Abril,Filipinas,75,267,0,342
2018,Abril,Finlandia,60,98,0,158
2018,Abril,Francia,2679,3782,0,6461
2018,Abril,Gabón,0,1,0,1
2018,Abril,Georgia,3,3,0,6
2018,Abril,Ghana,3,17,0,20
2018,Abril,Granada,1,7,0,8
2018,Abril,Grecia,41,108,0,149
2018,Abril,Guatemala,603,1204,0,1807
2018,Abril,Guyana,23,31,0,54
2018,Abril,Haití,16,35,0,51
2018,Abril,Honduras,397,550,0,947
2018,Abril,Hong Kong,8,16,0,24
2018,Abril,Hungría,66,93,0,159
2018,Abril,India,115,535,0,650
2018,Abril,Indonesia,13,35,0,48
2018,Abril,Iraq,1,2,0,3
2018,Abril,Irán,7,17,0,24
2018,Abril,República de Irlanda,187,315,0,502
2018,Abril,Islandia,7,16,0,23
2018,Abril,Israel,894,1680,1,2575
2018,Abril,Italia,961,2249,0,3210
2018,Abril,Jamaica,45,56,0,101
2018,Abril,Japón,199,556,0,755
2018,Abril,Jordania,6,7,0,13
2018,Abril,Kazajistán,2,2,0,4
2018,Abril,Kenia,6,15,0,21
2018,Abril,Kuwait,0,7,0,7
2018,Abril,República de Kosovo,1,0,0,1
2018,Abril,Letonia,9,19,0,28
2018,Abril,Lituania,29,28,0,57
2018,Abril,Líbano,18,24,0,42
2018,Abril,Liberia,1,0,0,1
2018,Abril,Liechtenstein,1,3,0,4
2018,Abril,Luxemburgo,10,12,0,22
2018,Abril,Macedonia,2,4,0,6
2018,Abril,Madagascar,2,1,0,3
2018,Abril,Malasia,39,53,1,93
2018,Abril,Malawi,0,2,0,2
2018,Abril,Maldivas,1,0,0,1
2018,Abril,Malí,0,1,0,1
2018,Abril,Malta,1,5,0,6
2018,Abril,Marruecos,15,20,0,35
2018,Abril,Mauricio,0,6,0,6
2018,Abril,México,5251,9886,0,15137
2018,Abril,República de Moldavia,2,3,0,5
2018,Abril,Mónaco,1,1,0,2
2018,Abril,Mongolia,1,0,0,1
2018,Abril,Montenegro,1,5,0,6
2018,Abril,Mozambique,1,3,0,4
2018,Abril,Myanmar,1,0,0,1
2018,Abril,Namibia,1,1,0,2
2018,Abril,Nepal,2,4,0,6
2018,Abril,Nicaragua,131,178,0,309
2018,Abril,Nigeria,1,6,0,7
2018,Abril,Noruega,112,150,0,262
2018,Abril,Nueva Zelanda,109,170,0,279
2018,Abril,Omán,0,1,0,1
2018,Abril,Pakistán,3,14,0,17
2018,Abril,Panamá,3630,3794,0,7424
2018,Abril,Paraguay,356,290,0,646
2018,Abril,Perú,5462,6610,0,12072
2018,Abril,Palestina,2,1,0,3
2018,Abril,Polonia,212,267,0,479
2018,Abril,Portugal,321,682,0,1003
2018,Abril,Qatar,1,5,0,6
2018,Abril,Reino Unido de Gran Bretaña e Irlanda del Norte,1587,2692,0,4279
2018,Abril,República CentroÁfricana,1,0,0,1
2018,Abril,Federación de Rusia,209,259,0,468
2018,Abril,República Dominicana,833,902,0,1735
2018,Abril,Rumania,108,95,0,203
2018,Abril,Rwanda,1,1,0,2
2018,Abril,San Cristóbal y Nevis,3,4,0,7
2018,Abril,San Marino,1,2,0,3
2018,Abril,San  Vicente y las Granadinas,0,3,0,3
2018,Abril,Santa Lucia,3,8,0,11
2018,Abril,Santa Sede/Ciudad del Vaticano,0,2,0,2
2018,Abril,Senegal,0,3,0,3
2018,Abril,Serbia,12,33,0,45
2018,Abril,Seychelles,0,1,0,1
2018,Abril,Sierra Leona,0,1,0,1
2018,Abril,Singapur,23,33,0,56
2018,Abril,República Árabe Siria,0,5,0,5
2018,Abril,Sri Lanka,3,4,0,7
2018,Abril,Sudáfrica,23,71,0,94
2018,Abril,Sudán,0,2,0,2
2018,Abril,Suecia,261,369,0,630
2018,Abril,Suiza,620,901,0,1521
2018,Abril,Surinam,26,28,0,54
2018,Abril,Taiwán,83,122,0,205
2018,Abril,Tailandia,41,33,0,74
2018,Abril,Tanzania,0,1,0,1
2018,Abril,Togo,0,1,0,1
2018,Abril,Trinidad y Tobago,45,79,0,124
2018,Abril,Túnez,4,9,0,13
2018,Abril,Turquía,210,447,0,657
2018,Abril,Ucrania,29,48,0,77
2018,Abril,Uganda,2,1,0,3
2018,Abril,Uruguay,837,1003,96,1936
2018,Abril,Uzbekistán,1,0,0,1
2018,Abril,Venezuela,56119,67022,3,123144
2018,Abril,Vietnam,6,6,0,12
2018,Abril,Islas Vírgenes Británicas/Territorio Británico de Ultramar,0,1,0,1
2018,Abril,República Árabe de Yemen,0,4,0,4
2018,Abril,Zambia,1,1,0,2
2018,Abril,Zimbabue,0,4,0,4
2018,Abril,Anguila/Territorio Británico de Ultramar,1,0,0,1
2018,Abril,Refugiado,10,7,0,17
2018,Abril,Desconocido,117,207,0,324
2018,Mayo,Albania,2,3,0,5
2018,Mayo,Alemania,1840,2817,0,4657
2018,Mayo,Andorra,1,9,0,10
2018,Mayo,Antigua y Barbuda,1,10,0,11
2018,Mayo,Países Bajos,1729,2282,0,4011
2018,Mayo,Arabia Saudita,0,7,0,7
2018,Mayo,Argelia,4,2,0,6
2018,Mayo,Argentina,8179,8600,1,16780
2018,Mayo,República de Armenia,3,2,0,5
2018,Mayo,Australia,466,807,1,1274
2018,Mayo,Austria,169,309,0,478
2018,Mayo,Azerbaiyán,2,8,0,10
2018,Mayo,Bahamas,5,24,0,29
2018,Mayo,Bahréin,0,1,0,1
2018,Mayo,Bangladesh,4,1,0,5
2018,Mayo,Barbados,21,24,0,45
2018,Mayo,República de Belarús,9,1,0,10
2018,Mayo,Bélgica,231,455,0,686
2018,Mayo,Belice,8,10,0,18
2018,Mayo,Bermudas/Territorio Británico de Ultramar,2,2,0,4
2018,Mayo,Bolivia,800,674,1,1475
2018,Mayo,Bosnia y Herzegovina,6,8,0,14
2018,Mayo,Botsuana,0,1,0,1
2018,Mayo,Brasil,7168,8139,0,15307
2018,Mayo,Brunei Darussalam,1,0,0,1
2018,Mayo,Bulgaria,51,49,0,100
2018,Mayo,Burkina Faso,1,2,0,3
2018,Mayo,Bután,0,1,0,1
2018,Mayo,Islas Caimán/Territorio Británico de Ultramar,6,3,0,9
2018,Mayo,Camboya,0,1,0,1
2018,Mayo,Camerún,1,6,0,7
2018,Mayo,Canadá,1625,2427,0,4052
2018,Mayo,España,3776,7075,0,10851
2018,Mayo,República Del Congo,0,1,0,1
2018,Mayo,República Democrática del Congo,7,4,0,11
2018,Mayo,República de Corea,236,460,0,696
2018,Mayo,Costa de Marfil,0,2,0,2
2018,Mayo,Costa Rica,1703,2249,0,3952
2018,Mayo,Croacia,13,55,0,68
2018,Mayo,Cuba,242,420,0,662
2018,Mayo,Curazao,0,1,0,1
2018,Mayo,República Checa,58,111,0,169
2018,Mayo,Chile,5353,6870,0,12223
2018,Mayo,China,515,1129,0,1644
2018,Mayo,Chipre,5,8,0,13
2018,Mayo,Dinamarca,115,184,0,299
2018,Mayo,Dominica,3,6,0,9
2018,Mayo,Ecuador,4901,6035,0,10936
2018,Mayo,Egipto,8,32,0,40
2018,Mayo,El Salvador,1049,1269,0,2318
2018,Mayo,Emiratos Árabes,2,11,0,13
2018,Mayo,Eslovaquia,28,46,0,74
2018,Mayo,Eslovenia,10,20,0,30
2018,Mayo,Estados Unidos de América,19604,31957,3,51564
2018,Mayo,Estonia,10,9,0,19
2018,Mayo,Etiopia,0,2,0,2
2018,Mayo,Islas Fiji,1,1,0,2
2018,Mayo,Filipinas,62,297,0,359
2018,Mayo,Finlandia,69,81,0,150
2018,Mayo,Francia,1993,3046,0,5039
2018,Mayo,Gabón,1,0,0,1
2018,Mayo,Georgia,1,8,0,9
2018,Mayo,Ghana,4,5,0,9
2018,Mayo,Granada,3,4,0,7
2018,Mayo,Grecia,28,98,0,126
2018,Mayo,Guatemala,590,1096,0,1686
2018,Mayo,Guyana,8,22,0,30
2018,Mayo,Haití,18,27,0,45
2018,Mayo,Honduras,383,470,0,853
2018,Mayo,Hong Kong,9,16,0,25
2018,Mayo,Hungría,40,73,0,113
2018,Mayo,India,129,606,1,736
2018,Mayo,Indonesia,32,55,0,87
2018,Mayo,Irán,10,19,0,29
2018,Mayo,República de Irlanda,197,306,0,503
2018,Mayo,Islandia,9,11,0,20
2018,Mayo,Israel,472,995,0,1467
2018,Mayo,Italia,810,2043,1,2854
2018,Mayo,Jamaica,34,54,0,88
2018,Mayo,Japón,160,573,0,733
2018,Mayo,Jordania,2,3,0,5
2018,Mayo,Kazajistán,10,13,0,23
2018,Mayo,Kenia,6,12,0,18
2018,Mayo,Kirguistán,2,0,0,2
2018,Mayo,Kuwait,2,2,0,4
2018,Mayo,República de Kosovo,5,1,0,6
2018,Mayo,Letonia,7,9,0,16
2018,Mayo,Lituania,25,39,0,64
2018,Mayo,Líbano,18,39,0,57
2018,Mayo,Libia,0,1,0,1
2018,Mayo,Liechtenstein,0,3,0,3
2018,Mayo,Luxemburgo,3,10,0,13
2018,Mayo,Macedonia,1,3,0,4
2018,Mayo,Madagascar,3,0,0,3
2018,Mayo,Malasia,37,39,1,77
2018,Mayo,Malí,1,1,0,2
2018,Mayo,Malta,3,7,0,10
2018,Mayo,Marruecos,6,12,0,18
2018,Mayo,Mauricio,0,8,0,8
2018,Mayo,México,5623,9491,1,15115
2018,Mayo,República de Moldavia,2,2,0,4
2018,Mayo,Mónaco,1,2,0,3
2018,Mayo,Mongolia,4,11,0,15
2018,Mayo,Montenegro,0,5,0,5
2018,Mayo,Mozambique,1,4,0,5
2018,Mayo,Myanmar,3,12,0,15
2018,Mayo,Nepal,3,7,0,10
2018,Mayo,Nicaragua,138,164,0,302
2018,Mayo,Nigeria,5,17,0,22
2018,Mayo,Noruega,112,131,0,243
2018,Mayo,Nueva Zelanda,95,173,0,268
2018,Mayo,Pakistán,3,20,0,23
2018,Mayo,Panamá,3047,3376,1,6424
2018,Mayo,Paraguay,420,337,0,757
2018,Mayo,Perú,5917,6679,0,12596
2018,Mayo,Palestina,0,1,0,1
2018,Mayo,Polonia,173,241,0,414
2018,Mayo,Portugal,233,536,0,769
2018,Mayo,Qatar,0,1,0,1
2018,Mayo,Reino Unido de Gran Bretaña e Irlanda del Norte,1435,2592,0,4027
2018,Mayo,República CentroÁfricana,1,0,0,1
2018,Mayo,Federación de Rusia,190,234,0,424
2018,Mayo,República Dominicana,880,1015,0,1895
2018,Mayo,Rumania,146,112,0,258
2018,Mayo,Rwanda,0,1,0,1
2018,Mayo,San Cristóbal y Nevis,2,3,0,5
2018,Mayo,San  Vicente y las Granadinas,12,12,0,24
2018,Mayo,Santa Lucia,7,10,0,17
2018,Mayo,Senegal,0,3,0,3
2018,Mayo,Serbia,13,30,0,43
2018,Mayo,Singapur,38,45,0,83
2018,Mayo,República Árabe Siria,0,2,0,2
2018,Mayo,Sri Lanka,1,11,0,12
2018,Mayo,Sudáfrica,28,56,0,84
2018,Mayo,Sudán,1,2,0,3
2018,Mayo,Suecia,181,285,0,466
2018,Mayo,Suiza,445,768,0,1213
2018,Mayo,Surinam,23,46,0,69
2018,Mayo,Taiwán,84,109,0,193
2018,Mayo,Tailandia,16,25,0,41
2018,Mayo,Tanzania,0,3,0,3
2018,Mayo,Trinidad y Tobago,40,89,0,129
2018,Mayo,Túnez,1,8,0,9
2018,Mayo,Turquía,166,341,0,507
2018,Mayo,Ucrania,22,58,0,80
2018,Mayo,Uganda,1,1,0,2
2018,Mayo,Uruguay,750,945,24,1719
2018,Mayo,Uzbekistán,1,1,0,2
2018,Mayo,Venezuela,53934,60466,1,114401
2018,Mayo,Vietnam,6,7,0,13
2018,Mayo,República Árabe de Yemen,0,1,0,1
2018,Mayo,Zambia,1,0,0,1
2018,Mayo,Zimbabue,2,3,0,5
2018,Mayo,Anguila/Territorio Británico de Ultramar,0,1,0,1
2018,Mayo,Refugiado,4,2,0,6
2018,Mayo,Desconocido,88,166,0,254
2018,Junio,Afganistán,0,2,0,2
2018,Junio,Albania,3,5,0,8
2018,Junio,Alemania,1908,2652,0,4560
2018,Junio,Andorra,1,7,0,8
2018,Junio,Antigua y Barbuda,5,7,0,12
2018,Junio,Países Bajos,1704,2299,3,4006
2018,Junio,Arabia Saudita,1,18,0,19
2018,Junio,Argelia,2,7,0,9
2018,Junio,Argentina,7449,7316,1,14766
2018,Junio,República de Armenia,1,1,0,2
2018,Junio,Australia,513,854,0,1367
2018,Junio,Austria,144,239,0,383
2018,Junio,Azerbaiyán,2,3,0,5
2018,Junio,Bahamas,15,18,0,33
2018,Junio,Bahréin,0,1,0,1
2018,Junio,Bangladesh,3,2,0,5
2018,Junio,Barbados,21,20,0,41
2018,Junio,República de Belarús,5,3,0,8
2018,Junio,Bélgica,366,558,0,924
2018,Junio,Belice,9,15,0,24
2018,Junio,Benín,1,3,0,4
2018,Junio,Bermudas/Territorio Británico de Ultramar,0,4,0,4
2018,Junio,Bolivia,817,887,3,1707
2018,Junio,Bosnia y Herzegovina,2,8,0,10
2018,Junio,Botsuana,1,0,0,1
2018,Junio,Brasil,6528,7398,2,13928
2018,Junio,Brunei Darussalam,1,1,0,2
2018,Junio,Bulgaria,35,31,0,66
2018,Junio,Burkina Faso,0,1,0,1
2018,Junio,Burundi,0,2,0,2
2018,Junio,Bután,1,0,0,1
2018,Junio,Cabo Verde,2,2,0,4
2018,Junio,Islas Caimán/Territorio Británico de Ultramar,13,7,0,20
2018,Junio,Camerún,6,3,0,9
2018,Junio,Canadá,1557,2354,0,3911
2018,Junio,España,4286,7099,0,11385
2018,Junio,República Democrática del Congo,5,3,0,8
2018,Junio,República de Corea,300,482,0,782
2018,Junio,Costa de Marfil,1,3,0,4
2018,Junio,Costa Rica,1801,2114,0,3915
2018,Junio,Croacia,17,49,0,66
2018,Junio,Cuba,280,541,0,821
2018,Junio,República Checa,62,104,0,166
2018,Junio,Chile,5028,6102,0,11130
2018,Junio,China,509,1073,0,1582
2018,Junio,Chipre,10,8,0,18
2018,Junio,Dinamarca,167,267,0,434
2018,Junio,Dominica,5,8,0,13
2018,Junio,Ecuador,4327,6204,1,10532
2018,Junio,Egipto,8,27,0,35
2018,Junio,El Salvador,866,1141,0,2007
2018,Junio,Emiratos Árabes,8,14,0,22
2018,Junio,Eslovaquia,30,25,0,55
2018,Junio,Eslovenia,11,23,0,34
2018,Junio,Estados Unidos de América,27439,39116,0,66555
2018,Junio,Estonia,14,12,0,26
2018,Junio,Etiopia,3,17,0,20
2018,Junio,Filipinas,62,215,0,277
2018,Junio,Finlandia,71,70,0,141
2018,Junio,Francia,2043,3045,0,5088
2018,Junio,Gabón,1,1,0,2
2018,Junio,Georgia,3,0,0,3
2018,Junio,Ghana,1,4,0,5
2018,Junio,Granada,2,6,0,8
2018,Junio,Grecia,28,81,0,109
2018,Junio,Guatemala,857,1184,1,2042
2018,Junio,Guyana,14,17,0,31
2018,Junio,Guinea Ecuatorial,1,2,0,3
2018,Junio,Haití,21,36,0,57
2018,Junio,Honduras,362,478,0,840
2018,Junio,Hong Kong,19,11,0,30
2018,Junio,Hungría,32,62,0,94
2018,Junio,India,144,568,1,713
2018,Junio,Indonesia,30,46,0,76
2018,Junio,Iraq,1,3,0,4
2018,Junio,Irán,4,22,1,27
2018,Junio,República de Irlanda,258,383,0,641
2018,Junio,Islandia,6,10,0,16
2018,Junio,Israel,256,671,0,927
2018,Junio,Italia,961,2205,0,3166
2018,Junio,Jamaica,37,70,0,107
2018,Junio,Japón,238,586,0,824
2018,Junio,Jordania,2,7,0,9
2018,Junio,Kazajistán,1,2,0,3
2018,Junio,Kenia,8,9,0,17
2018,Junio,Kirguistán,0,3,0,3
2018,Junio,Kuwait,4,5,0,9
2018,Junio,República de Kosovo,0,2,0,2
2018,Junio,Lesoto,0,1,0,1
2018,Junio,Letonia,8,19,0,27
2018,Junio,Lituania,39,28,0,67
2018,Junio,Líbano,20,32,0,52
2018,Junio,Liechtenstein,0,1,0,1
2018,Junio,Luxemburgo,18,14,0,32
2018,Junio,Macedonia,1,4,0,5
2018,Junio,Madagascar,0,1,0,1
2018,Junio,Malasia,31,27,0,58
2018,Junio,Malawi,0,3,0,3
2018,Junio,Maldivas,1,0,0,1
2018,Junio,Malta,2,9,0,11
2018,Junio,Marruecos,13,18,0,31
2018,Junio,Islas Marshall,1,0,0,1
2018,Junio,Mauricio,5,3,0,8
2018,Junio,Mauritania,0,1,0,1
2018,Junio,México,5543,8687,2,14232
2018,Junio,República de Moldavia,2,2,0,4
2018,Junio,Mónaco,1,0,0,1
2018,Junio,Mongolia,2,0,0,2
2018,Junio,Montenegro,1,3,0,4
2018,Junio,Mozambique,1,2,0,3
2018,Junio,Myanmar,0,4,0,4
2018,Junio,Nepal,5,5,0,10
2018,Junio,Nicaragua,142,139,0,281
2018,Junio,Nigeria,6,13,0,19
2018,Junio,Níger,1,0,0,1
2018,Junio,Noruega,233,266,0,499
2018,Junio,Nueva Zelanda,128,187,0,315
2018,Junio,Omán,0,1,0,1
2018,Junio,Pakistán,2,22,0,24
2018,Junio,Panamá,3433,3514,0,6947
2018,Junio,Paraguay,418,362,0,780
2018,Junio,Perú,5146,6178,0,11324
2018,Junio,Palestina,3,3,0,6
2018,Junio,Polonia,148,216,0,364
2018,Junio,Portugal,213,504,0,717
2018,Junio,Qatar,0,2,0,2
2018,Junio,Reino Unido de Gran Bretaña e Irlanda del Norte,1568,2703,0,4271
2018,Junio,República CentroÁfricana,0,1,0,1
2018,Junio,Federación de Rusia,164,165,0,329
2018,Junio,República Dominicana,757,1021,0,1778
2018,Junio,Rumania,125,95,0,220
2018,Junio,Rwanda,0,1,0,1
2018,Junio,San Cristóbal y Nevis,2,7,0,9
2018,Junio,San  Vicente y las Granadinas,0,9,0,9
2018,Junio,Santa Lucia,7,4,0,11
2018,Junio,Santa Sede/Ciudad del Vaticano,0,1,0,1
2018,Junio,Senegal,0,1,0,1
2018,Junio,Serbia,12,24,0,36
2018,Junio,Sierra Leona,0,2,0,2
2018,Junio,Singapur,37,54,0,91
2018,Junio,República Árabe Siria,1,4,0,5
2018,Junio,Somalia,0,1,0,1
2018,Junio,Sri Lanka,1,5,0,6
2018,Junio,Sudáfrica,33,58,0,91
2018,Junio,Sudán,2,3,0,5
2018,Junio,Suecia,292,432,0,724
2018,Junio,Suiza,548,834,0,1382
2018,Junio,Surinam,6,36,0,42
2018,Junio,Taiwán,81,84,0,165
2018,Junio,República de Tayikistán,1,0,0,1
2018,Junio,Tailandia,17,15,0,32
2018,Junio,Tanzania,3,0,0,3
2018,Junio,Togo,0,2,0,2
2018,Junio,Trinidad y Tobago,52,67,0,119
2018,Junio,Túnez,3,3,0,6
2018,Junio,Turkmenistán,1,0,0,1
2018,Junio,Turquía,195,358,0,553
2018,Junio,Ucrania,42,47,0,89
2018,Junio,Uganda,3,5,0,8
2018,Junio,Uruguay,742,835,7,1584
2018,Junio,Uzbekistán,1,1,0,2
2018,Junio,Venezuela,44573,49862,1,94436
2018,Junio,Vietnam,5,4,0,9
2018,Junio,Islas Vírgenes Británicas/Territorio Británico de Ultramar,1,1,0,2
2018,Junio,República Árabe de Yemen,0,4,0,4
2018,Junio,Zambia,0,2,0,2
2018,Junio,Zimbabue,0,3,0,3
2018,Junio,Refugiado Otro,0,1,0,1
2018,Junio,Refugiado,1,7,0,8
2018,Junio,Desconocido,111,194,0,305
